NCESID,ID2,Geography,Estimate__RACE___Total_population,Estimate__RACE___One_race___White,Estimate__RACE___One_race___Black_or_African_American,Estimate__RACE___One_race___Asian,Estimate__RACE___One_race___Some_other_race,Estimate__HISPANIC_OR_LATINO_AND_RACE___Total_population___Hispa,Estimate__HISPANIC_OR_LATINO_AND_RACE___Total_population___Not_H
360010202416,36081004300,"Census Tract 43, Queens County, New York",2380,784,889,59,473,1190,1190
360095706068,36081004300,"Census Tract 43, Queens County, New York",2380,784,889,59,473,1190,1190
360010202309,36081003900,"Census Tract 39, Queens County, New York",1574,890,119,168,356,891,683
360012200249,36081077908,"Census Tract 779.08, Queens County, New York",4101,1326,899,1242,285,671,3430
360012200954,36081077908,"Census Tract 779.08, Queens County, New York",4101,1326,899,1242,285,671,3430
360012302392,36081100801,"Census Tract 1008.01, Queens County, New York",2307,1253,897,10,52,380,1927
360009802464,36081023500,"Census Tract 235, Queens County, New York",8577,4328,159,2782,1136,4834,3743
360010004611,36081024000,"Census Tract 240, Queens County, New York",6132,1059,1086,1049,2647,3148,2984
360010202077,36081025100,"Census Tract 251, Queens County, New York",5560,2650,15,1972,852,1921,3639
360101806192,36081097204,"Census Tract 972.04, Queens County, New York",3530,699,2333,78,249,693,2837
360012302704,36081003800,"Census Tract 38, Queens County, New York",2586,914,159,607,732,1538,1048
360012302273,36081004200,"Census Tract 42, Queens County, New York",5005,1210,264,2295,969,1888,3117
360009102781,36047021100,"Census Tract 211, Kings County, New York",1254,315,678,92,147,336,918
360012202664,36081102900,"Census Tract 1029, Queens County, New York",3699,2715,67,695,171,805,2894
360010003176,36081025800,"Census Tract 258, Queens County, New York",2004,77,1724,138,59,146,1858
360010002181,36081026000,"Census Tract 260, Queens County, New York",2795,122,1937,182,549,615,2180
360012202639,36081104700,"Census Tract 1047, Queens County, New York",6740,3950,47,2189,271,941,5799
360012202109,36081104700,"Census Tract 1047, Queens County, New York",6740,3950,47,2189,271,941,5799
360012305728,36081103202,"Census Tract 1032.02, Queens County, New York",7099,3841,2182,58,776,2347,4752
360011805732,36081103202,"Census Tract 1032.02, Queens County, New York",7099,3841,2182,58,776,2347,4752
360012301972,36081103202,"Census Tract 1032.02, Queens County, New York",7099,3841,2182,58,776,2347,4752
360012306104,36081103202,"Census Tract 1032.02, Queens County, New York",7099,3841,2182,58,776,2347,4752
360011903074,36047048500,"Census Tract 485, Kings County, New York",3241,1980,222,122,770,1461,1780
360011905929,36047048500,"Census Tract 485, Kings County, New York",3241,1980,222,122,770,1461,1780
360011903091,36047048500,"Census Tract 485, Kings County, New York",3241,1980,222,122,770,1461,1780
360011905702,36047048500,"Census Tract 485, Kings County, New York",3241,1980,222,122,770,1461,1780
360011903078,36047048500,"Census Tract 485, Kings County, New York",3241,1980,222,122,770,1461,1780
360011902533,36047048500,"Census Tract 485, Kings County, New York",3241,1980,222,122,770,1461,1780
360011902668,36047048500,"Census Tract 485, Kings County, New York",3241,1980,222,122,770,1461,1780
360012202314,36081103900,"Census Tract 1039, Queens County, New York",6865,4962,0,1670,221,1038,5827
360010205288,36081027900,"Census Tract 279, Queens County, New York",6016,3491,189,786,1360,4038,1978
360010202536,36081027300,"Census Tract 273, Queens County, New York",8114,5575,325,694,1168,6691,1423
360010206186,36081027300,"Census Tract 273, Queens County, New York",8114,5575,325,694,1168,6691,1423
360009802343,36081027100,"Census Tract 271, Queens County, New York",8706,2987,250,3911,1041,3867,4839
360010002510,36081027800,"Census Tract 278, Queens County, New York",2557,161,1997,0,255,593,1964
360010005534,36081027800,"Census Tract 278, Queens County, New York",2557,161,1997,0,255,593,1964
360103406224,36081028400,"Census Tract 284, Queens County, New York",4143,106,3519,0,473,387,3756
360015302665,36047062000,"Census Tract 620, Kings County, New York",2102,2078,0,24,0,36,2066
360012202661,36081098700,"Census Tract 987, Queens County, New York",2577,2148,46,334,32,316,2261
360012202476,36081094500,"Census Tract 945, Queens County, New York",3939,2558,43,699,579,1142,2797
360012302190,36081096400,"Census Tract 964, Queens County, New York",4085,737,2462,149,509,945,3140
360017005867,36047123700,"Census Tract 1237, Kings County, New York",6370,5207,223,32,816,1042,5328
360011902565,36047123700,"Census Tract 1237, Kings County, New York",6370,5207,223,32,816,1042,5328
360009902571,36081109900,"Census Tract 1099, Queens County, New York",3994,2301,130,1241,142,1039,2955
360012202148,36081114100,"Census Tract 1141, Queens County, New York",2176,1424,28,613,72,162,2014
360012205869,36081113900,"Census Tract 1139, Queens County, New York",3580,2101,38,1195,144,507,3073
360012201969,36081113900,"Census Tract 1139, Queens County, New York",3580,2101,38,1195,144,507,3073
360009902183,36081109700,"Census Tract 1097, Queens County, New York",1678,1176,33,333,126,257,1421
360009901917,36081109700,"Census Tract 1097, Queens County, New York",1678,1176,33,333,126,257,1421
360012302398,36081099200,"Census Tract 992, Queens County, New York",3983,1039,2371,6,391,1154,2829
360010202287,36081028700,"Census Tract 287, Queens County, New York",6099,4060,148,1546,187,2488,3611
360010204802,36081028900,"Census Tract 289, Queens County, New York",5522,2554,154,2201,474,2015,3507
360010202548,36081029300,"Census Tract 293, Queens County, New York",1164,424,9,629,12,322,842
360010002140,36081033402,"Census Tract 334.02, Queens County, New York",12877,239,12072,98,404,1555,11322
360010005935,36081033402,"Census Tract 334.02, Queens County, New York",12877,239,12072,98,404,1555,11322
360010002297,36081033402,"Census Tract 334.02, Queens County, New York",12877,239,12072,98,404,1555,11322
360010002317,36081033402,"Census Tract 334.02, Queens County, New York",12877,239,12072,98,404,1555,11322
360010006284,36081033402,"Census Tract 334.02, Queens County, New York",12877,239,12072,98,404,1555,11322
360010105734,36081033000,"Census Tract 330, Queens County, New York",7041,108,6040,243,623,841,6200
360010105833,36081033000,"Census Tract 330, Queens County, New York",7041,108,6040,243,623,841,6200
360010105733,36081033000,"Census Tract 330, Queens County, New York",7041,108,6040,243,623,841,6200
360010105875,36081033000,"Census Tract 330, Queens County, New York",7041,108,6040,243,623,841,6200
360010102765,36081032000,"Census Tract 320, Queens County, New York",4836,107,4235,48,190,315,4521
360010102227,36081032000,"Census Tract 320, Queens County, New York",4836,107,4235,48,190,315,4521
360010102742,36081032000,"Census Tract 320, Queens County, New York",4836,107,4235,48,190,315,4521
360010106285,36081032000,"Census Tract 320, Queens County, New York",4836,107,4235,48,190,315,4521
360010106286,36081032000,"Census Tract 320, Queens County, New York",4836,107,4235,48,190,315,4521
360010202045,36081031700,"Census Tract 317, Queens County, New York",6277,4862,150,573,487,1149,5128
360010202534,36081033900,"Census Tract 339, Queens County, New York",3466,1136,249,671,853,2093,1373
360009806060,36081040700,"Census Tract 407, Queens County, New York",7326,3396,453,504,2796,6436,890
360010102432,36081041400,"Census Tract 414, Queens County, New York",3896,116,3162,0,474,1049,2847
360009805244,36081041500,"Census Tract 415, Queens County, New York",3582,2056,100,638,677,2399,1183
360010006182,36081044602,"Census Tract 446.02, Queens County, New York",5008,484,1582,1649,1016,1484,3524
360010102483,36081045600,"Census Tract 456, Queens County, New York",1478,39,110,1311,4,18,1460
360010101997,36081047000,"Census Tract 470, Queens County, New York",3295,275,349,1403,603,612,2683
360010102362,36081046800,"Census Tract 468, Queens County, New York",3348,499,563,1334,771,841,2507
360009806028,36081046300,"Census Tract 463, Queens County, New York",3598,1902,50,1205,322,2248,1350
360009806066,36081046300,"Census Tract 463, Queens County, New York",3598,1902,50,1205,322,2248,1350
360009806084,36081046300,"Census Tract 463, Queens County, New York",3598,1902,50,1205,322,2248,1350
360010202022,36081004500,"Census Tract 45, Queens County, New York",3314,2249,212,509,201,714,2600
360010002333,36081044800,"Census Tract 448, Queens County, New York",2625,200,352,1388,388,558,2067
360010001965,36081044800,"Census Tract 448, Queens County, New York",2625,200,352,1388,388,558,2067
360009806179,36081047500,"Census Tract 475, Queens County, New York",4770,1565,34,2788,241,1309,3461
360012302268,36081005400,"Census Tract 54, Queens County, New York",5620,1941,304,1440,1238,2107,3513
360012302685,36081005800,"Census Tract 58, Queens County, New York",5824,2994,533,976,876,2665,3159
360012306047,36081005800,"Census Tract 58, Queens County, New York",5824,2994,533,976,876,2665,3159
360010102166,36081036600,"Census Tract 366, Queens County, New York",2977,14,2760,98,58,130,2847
360103506226,36081036600,"Census Tract 366, Queens County, New York",2977,14,2760,98,58,130,2847
360009802521,36081038100,"Census Tract 381, Queens County, New York",7509,3282,1124,301,2400,6182,1327
360010102089,36081037600,"Census Tract 376, Queens County, New York",6388,0,5726,227,229,399,5989
360010202466,36081007700,"Census Tract 77, Queens County, New York",1413,878,41,352,51,283,1130
360012302405,36081009600,"Census Tract 96, Queens County, New York",4043,891,477,1470,1083,1178,2865
360010202606,36081008300,"Census Tract 83, Queens County, New York",3872,1613,415,829,822,1494,2378
360012305269,36081008600,"Census Tract 86, Queens County, New York",2621,1345,145,498,564,962,1659
360010204893,36081035300,"Census Tract 353, Queens County, New York",2346,739,323,136,1108,1699,647
360010203146,36081035300,"Census Tract 353, Queens County, New York",2346,739,323,136,1108,1699,647
360010102254,36081035200,"Census Tract 352, Queens County, New York",2886,114,2554,17,83,132,2754
360010102169,36081035200,"Census Tract 352, Queens County, New York",2886,114,2554,17,83,132,2754
360010106190,36081035200,"Census Tract 352, Queens County, New York",2886,114,2554,17,83,132,2754
360009802084,36081043900,"Census Tract 439, Queens County, New York",4467,2375,155,215,1580,3735,732
360010202330,36081011500,"Census Tract 115, Queens County, New York",2389,1619,68,407,185,474,1915
360012302265,36081011000,"Census Tract 110, Queens County, New York",3323,767,343,958,1045,1123,2200
360012302379,36081010200,"Census Tract 102, Queens County, New York",3097,378,490,573,1458,934,2163
360010202093,36081007100,"Census Tract 71, Queens County, New York",3775,2497,58,709,386,906,2869
360010202451,36081010300,"Census Tract 103, Queens County, New York",3833,2736,79,632,229,611,3222
360012302863,36081012400,"Census Tract 124, Queens County, New York",2966,969,211,927,526,1188,1778
360012301790,36081012200,"Census Tract 122, Queens County, New York",3346,882,231,1279,453,1011,2335
360010202514,36081012301,"Census Tract 123.01, Queens County, New York",2692,2246,159,117,115,460,2232
360010004734,36081015600,"Census Tract 156, Queens County, New York",3385,324,752,1192,932,322,3063
360010002241,36081015400,"Census Tract 154, Queens County, New York",2452,191,229,700,1219,669,1783
360010202289,36081014900,"Census Tract 149, Queens County, New York",2283,1795,38,296,117,699,1584
360012302365,36081018000,"Census Tract 180, Queens County, New York",1234,198,486,333,111,215,1019
360012302558,36081017600,"Census Tract 176, Queens County, New York",2358,109,1034,297,695,346,2012
360010202887,36081016300,"Census Tract 163, Queens County, New York",4086,2118,1118,356,343,2262,1824
360010202544,36081016300,"Census Tract 163, Queens County, New York",4086,2118,1118,356,343,2262,1824
360010002448,36081017000,"Census Tract 170, Queens County, New York",2472,142,949,543,551,250,2222
360012302728,36081018401,"Census Tract 184.01, Queens County, New York",2411,100,1760,0,510,263,2148
360012302454,36081018402,"Census Tract 184.02, Queens County, New York",2324,100,1998,56,96,244,2080
360013504481,36081019200,"Census Tract 192, Queens County, New York",1903,277,1161,193,164,462,1441
360010002574,36081019600,"Census Tract 196, Queens County, New York",2777,255,1559,444,492,484,2293
360009802678,36081018900,"Census Tract 189, Queens County, New York",3409,1944,267,735,284,1645,1764
360009802860,36081018900,"Census Tract 189, Queens County, New York",3409,1944,267,735,284,1645,1764
360009803154,36081043701,"Census Tract 437.01, Queens County, New York",3743,1967,512,348,847,2338,1405
360010002222,36081020600,"Census Tract 206, Queens County, New York",1549,244,412,219,620,762,787
360012202592,36081077906,"Census Tract 779.06, Queens County, New York",3153,1781,171,855,214,524,2629
360010002322,36081021400,"Census Tract 214, Queens County, New York",6356,1522,460,2274,1730,2383,3973
360010002376,36081021600,"Census Tract 216, Queens County, New York",4289,1826,643,611,885,1421,2868
360009802355,36081058900,"Census Tract 589, Queens County, New York",4047,3370,41,98,427,1733,2314
360012202136,36081090700,"Census Tract 907, Queens County, New York",1227,683,0,395,85,239,988
360012302732,36081093800,"Census Tract 938, Queens County, New York",5775,4482,665,116,393,867,4908
360012305831,36081093800,"Census Tract 938, Queens County, New York",5775,4482,665,116,393,867,4908
360012306106,36081093800,"Census Tract 938, Queens County, New York",5775,4482,665,116,393,867,4908
360012306127,36081093800,"Census Tract 938, Queens County, New York",5775,4482,665,116,393,867,4908
360012302426,36081092800,"Census Tract 928, Queens County, New York",3497,3479,7,0,0,48,3449
360010102494,36081049200,"Census Tract 492, Queens County, New York",4453,743,2353,842,214,699,3754
360010102532,36081059800,"Census Tract 598, Queens County, New York",1788,83,1561,123,8,158,1630
360009802551,36081059900,"Census Tract 599, Queens County, New York",1381,1269,6,70,0,361,1020
360005504777,36081049600,"Census Tract 496, Queens County, New York",3055,453,558,1014,603,527,2528
360009801959,36081059500,"Census Tract 595, Queens County, New York",4271,3351,253,120,509,1530,2741
360009802292,36081059500,"Census Tract 595, Queens County, New York",4271,3351,253,120,509,1530,2741
360009802300,36081049302,"Census Tract 493.02, Queens County, New York",2286,1839,66,180,169,490,1796
360009805245,36081049302,"Census Tract 493.02, Queens County, New York",2286,1839,66,180,169,490,1796
360009806223,36081049302,"Census Tract 493.02, Queens County, New York",2286,1839,66,180,169,490,1796
360010102617,36081061400,"Census Tract 614, Queens County, New York",1411,76,1214,0,13,23,1388
360010102493,36081050800,"Census Tract 508, Queens County, New York",1813,43,1543,138,78,69,1744
360010102659,36081050800,"Census Tract 508, Queens County, New York",1813,43,1543,138,78,69,1744
360010105834,36081050800,"Census Tract 508, Queens County, New York",1813,43,1543,138,78,69,1744
360013504781,36081050800,"Census Tract 508, Queens County, New York",1813,43,1543,138,78,69,1744
360009802739,36081051300,"Census Tract 513, Queens County, New York",1956,1165,13,654,124,413,1543
360012202014,36081080900,"Census Tract 809, Queens County, New York",7595,4688,490,2069,229,1033,6562
360012202722,36081080900,"Census Tract 809, Queens County, New York",7595,4688,490,2069,229,1033,6562
360012204485,36081080900,"Census Tract 809, Queens County, New York",7595,4688,490,2069,229,1033,6562
360012204175,36081080900,"Census Tract 809, Queens County, New York",7595,4688,490,2069,229,1033,6562
360012202444,36081080301,"Census Tract 803.01, Queens County, New York",4521,1005,30,2414,814,1207,3314
360010105546,36081061800,"Census Tract 618, Queens County, New York",1866,80,1690,17,13,23,1843
360009802337,36081062100,"Census Tract 621, Queens County, New York",2526,2272,7,71,168,641,1885
360010102484,36081062600,"Census Tract 626, Queens County, New York",3078,150,2809,21,13,170,2908
360012201996,36081084500,"Census Tract 845, Queens County, New York",4807,462,538,3167,390,371,4436
360012205879,36081084500,"Census Tract 845, Queens County, New York",4807,462,538,3167,390,371,4436
360012301995,36081084000,"Census Tract 840, Queens County, New York",6208,1032,936,1993,1469,1208,5000
360009806040,36081053900,"Census Tract 539, Queens County, New York",4412,2920,99,869,383,2205,2207
360010101409,36081053401,"Census Tract 534.01, Queens County, New York",2104,53,1916,30,57,112,1992
360010101411,36081053401,"Census Tract 534.01, Queens County, New York",2104,53,1916,30,57,112,1992
360010101413,36081053401,"Census Tract 534.01, Queens County, New York",2104,53,1916,30,57,112,1992
360010101408,36081053401,"Census Tract 534.01, Queens County, New York",2104,53,1916,30,57,112,1992
360013502070,36081053500,"Census Tract 535, Queens County, New York",1329,662,8,84,543,1051,278
360009802442,36081063301,"Census Tract 633.01, Queens County, New York",1359,1267,0,0,80,332,1027
360009802423,36081063700,"Census Tract 637, Queens County, New York",3017,2562,13,206,76,979,2038
360010006188,36081064500,"Census Tract 645, Queens County, New York",2055,1159,19,563,236,328,1727
360010006209,36081064500,"Census Tract 645, Queens County, New York",2055,1159,19,563,236,328,1727
360009806278,36081064500,"Census Tract 645, Queens County, New York",2055,1159,19,563,236,328,1727
360010102172,36081063800,"Census Tract 638, Queens County, New York",3929,275,3343,202,20,233,3696
360012205727,36081086300,"Census Tract 863, Queens County, New York",6903,722,152,5225,724,1308,5595
360012202650,36081086300,"Census Tract 863, Queens County, New York",6903,722,152,5225,724,1308,5595
360010102563,36081064600,"Census Tract 646, Queens County, New York",3026,22,2839,0,122,150,2876
360012302013,36081086400,"Census Tract 864, Queens County, New York",2673,953,273,670,544,941,1732
360012302699,36081089200,"Census Tract 892, Queens County, New York",8272,7989,0,87,143,465,7807
360012302531,36081088400,"Census Tract 884, Queens County, New York",7500,6889,86,120,202,954,6546
360012202711,36081088901,"Census Tract 889.01, Queens County, New York",10605,3023,263,5599,1463,2092,8513
360012204892,36081088901,"Census Tract 889.01, Queens County, New York",10605,3023,263,5599,1463,2092,8513
360012205503,36081088901,"Census Tract 889.01, Queens County, New York",10605,3023,263,5599,1463,2092,8513
360012302460,36081084602,"Census Tract 846.02, Queens County, New York",1141,223,129,339,414,418,723
360009802319,36081054500,"Census Tract 545, Queens County, New York",3757,2639,18,391,514,2298,1459
360010102409,36081054200,"Census Tract 542, Queens County, New York",5842,1237,1381,1465,770,1346,4496
360009802474,36081065900,"Census Tract 659, Queens County, New York",1809,1770,0,32,0,193,1616
360010102506,36081066000,"Census Tract 660, Queens County, New York",3780,540,3110,75,55,377,3403
360009804563,36081048300,"Census Tract 483, Queens County, New York",4128,1495,27,1698,714,1842,2286
360009803117,36081048900,"Census Tract 489, Queens County, New York",1599,446,8,858,274,557,1042
360009801406,36081048500,"Census Tract 485, Queens County, New York",4562,1016,86,3083,303,940,3622
360009802386,36081047900,"Census Tract 479, Queens County, New York",6039,1584,61,4148,155,1040,4999
360009805726,36081047900,"Census Tract 479, Queens County, New York",6039,1584,61,4148,155,1040,4999
360009804609,36081055500,"Census Tract 555, Queens County, New York",2247,1862,132,37,167,1693,554
360013502305,36081055300,"Census Tract 553, Queens County, New York",2368,1455,41,312,421,1523,845
360009805564,36081055300,"Census Tract 553, Queens County, New York",2368,1455,41,312,421,1523,845
360009802284,36081055700,"Census Tract 557, Queens County, New York",3894,3024,79,297,405,2231,1663
360009802215,36081066300,"Census Tract 663, Queens County, New York",2543,2238,0,265,40,140,2403
360010105925,36081056800,"Census Tract 568, Queens County, New York",4880,760,3433,195,267,1021,3859
360010102666,36081066400,"Census Tract 664, Queens County, New York",9961,637,8368,376,326,494,9467
360010002508,36081069300,"Census Tract 693, Queens County, New York",2565,1471,103,759,167,773,1792
360010102630,36081069400,"Census Tract 694, Queens County, New York",3298,339,2804,57,48,403,2895
360009902580,36081140901,"Census Tract 1409.01, Queens County, New York",954,404,11,538,0,81,873
360009902145,36081144700,"Census Tract 1447, Queens County, New York",3338,737,466,1617,251,597,2741
360009902568,36081144700,"Census Tract 1447, Queens County, New York",3338,737,466,1617,251,597,2741
360009901919,36081138501,"Census Tract 1385.01, Queens County, New York",4529,1515,0,2824,171,403,4126
360009902687,36081138501,"Census Tract 1385.01, Queens County, New York",4529,1515,0,2824,171,403,4126
360012204610,36081146300,"Census Tract 1463, Queens County, New York",3059,1940,16,920,166,254,2805
360009902358,36081147900,"Census Tract 1479, Queens County, New York",4901,2626,29,1539,500,1225,3676
360009902281,36081150701,"Census Tract 1507.01, Queens County, New York",3033,2191,2,797,10,223,2810
360009902372,36081148300,"Census Tract 1483, Queens County, New York",2804,1694,36,989,9,155,2649
360010002612,36081069702,"Census Tract 697.02, Queens County, New York",3499,2061,33,1284,68,193,3306
360012302198,36081078800,"Census Tract 788, Queens County, New York",1617,131,1139,165,104,88,1529
360010002523,36081072900,"Census Tract 729, Queens County, New York",1155,678,34,419,0,92,1063
360010002723,36081074500,"Census Tract 745, Queens County, New York",3887,2377,296,687,272,585,3302
360010006067,36081073900,"Census Tract 739, Queens County, New York",5415,3811,244,1013,261,730,4685
360012205980,36081077903,"Census Tract 779.03, Queens County, New York",2958,1625,134,614,315,492,2466
360012202589,36081077902,"Census Tract 779.02, Queens County, New York",5223,4570,200,380,57,226,4997
360010102162,36081048200,"Census Tract 482, Queens County, New York",1608,184,391,488,384,519,1089
360009902608,36081157902,"Census Tract 1579.02, Queens County, New York",3902,1653,174,1725,134,463,3439
360009902428,36081157902,"Census Tract 1579.02, Queens County, New York",3902,1653,174,1725,134,463,3439
360009902099,36081162100,"Census Tract 1621, Queens County, New York",7164,2375,315,3155,1012,1906,5258
360009902654,36081157903,"Census Tract 1579.03, Queens County, New York",3695,1775,0,1775,76,195,3500
360013504818,36081157903,"Census Tract 1579.03, Queens County, New York",3695,1775,0,1775,76,195,3500
360009902488,36081157101,"Census Tract 1571.01, Queens County, New York",7620,3041,385,3709,293,1042,6578
360010105544,36081156700,"Census Tract 1567, Queens County, New York",1357,343,368,590,33,209,1148
360009905567,36081156700,"Census Tract 1567, Queens County, New York",1357,343,368,590,33,209,1148
360013502843,36081152902,"Census Tract 1529.02, Queens County, New York",5029,2358,373,2171,35,79,4950
360013502858,36081155102,"Census Tract 1551.02, Queens County, New York",7629,4433,785,1765,251,738,6891
360009902642,36081155102,"Census Tract 1551.02, Queens County, New York",7629,4433,785,1765,251,738,6891
360009902726,36081152901,"Census Tract 1529.01, Queens County, New York",6646,2910,3,3608,14,748,5898
360012202119,36081120500,"Census Tract 1205, Queens County, New York",2702,341,22,2037,263,186,2516
360012202402,36081119500,"Census Tract 1195, Queens County, New York",1377,540,95,506,191,348,1029
360009902610,36081122300,"Census Tract 1223, Queens County, New York",3806,1671,21,1614,468,462,3344
360012202681,36081122701,"Census Tract 1227.01, Queens County, New York",11015,4127,765,3469,2363,3311,7704
360012202555,36081125700,"Census Tract 1257, Queens County, New York",3116,776,415,1493,108,268,2848
360012205830,36081125700,"Census Tract 1257, Queens County, New York",3116,776,415,1493,108,268,2848
360013502770,36081125700,"Census Tract 1257, Queens County, New York",3116,776,415,1493,108,268,2848
360012202683,36081122702,"Census Tract 1227.02, Queens County, New York",6386,2305,2007,1023,858,1990,4396
360012202586,36081121500,"Census Tract 1215, Queens County, New York",4434,884,57,2765,612,815,3619
360009902030,36081130100,"Census Tract 1301, Queens County, New York",3849,1643,562,1039,479,674,3175
360009902716,36081134100,"Census Tract 1341, Queens County, New York",3443,998,32,2244,42,245,3198
360009902129,36081134700,"Census Tract 1347, Queens County, New York",9563,2867,643,4803,761,1610,7953
360013504699,36081134700,"Census Tract 1347, Queens County, New York",9563,2867,643,4803,761,1610,7953
360009902301,36081136700,"Census Tract 1367, Queens County, New York",6171,2292,287,2919,184,786,5385
360009902203,36081136700,"Census Tract 1367, Queens County, New York",6171,2292,287,2919,184,786,5385
360012302671,36081101002,"Census Tract 1010.02, Queens County, New York",4549,3825,560,11,141,486,4063
360012202637,36081101700,"Census Tract 1017, Queens County, New York",5818,4554,1,959,80,503,5315
360012202703,36081101700,"Census Tract 1017, Queens County, New York",5818,4554,1,959,80,503,5315
360012302634,36081094202,"Census Tract 942.02, Queens County, New York",4686,1664,2128,456,215,1209,3477
360012301918,36081094201,"Census Tract 942.01, Queens County, New York",3765,1824,1444,220,176,1184,2581
360012305731,36081094201,"Census Tract 942.01, Queens County, New York",3765,1824,1444,220,176,1184,2581
360012306194,36081094201,"Census Tract 942.01, Queens County, New York",3765,1824,1444,220,176,1184,2581
360012306277,36081094201,"Census Tract 942.01, Queens County, New York",3765,1824,1444,220,176,1184,2581
360012201950,36081116100,"Census Tract 1161, Queens County, New York",4581,979,230,2758,324,996,3585
360012202115,36081116700,"Census Tract 1167, Queens County, New York",1905,359,14,1072,434,585,1320
360010302239,36085015602,"Census Tract 156.02, Richmond County, New York",3449,3347,0,52,0,140,3309
360013502170,36085014605,"Census Tract 146.05, Richmond County, New York",3496,3259,4,169,26,354,3142
360010302062,36085015601,"Census Tract 156.01, Richmond County, New York",6245,5625,4,298,141,812,5433
360010302137,36085016901,"Census Tract 169.01, Richmond County, New York",3145,2589,159,249,89,702,2443
360010302090,36085001100,"Census Tract 11, Richmond County, New York",2884,1128,1502,29,125,757,2127
360010306184,36085001100,"Census Tract 11, Richmond County, New York",2884,1128,1502,29,125,757,2127
360010302086,36085002900,"Census Tract 29, Richmond County, New York",5829,1281,3030,457,882,2124,3705
360010302216,36085002900,"Census Tract 29, Richmond County, New York",5829,1281,3030,457,882,2124,3705
360010306035,36085002100,"Census Tract 21, Richmond County, New York",3921,1862,1094,190,598,1670,2251
360103706228,36085002100,"Census Tract 21, Richmond County, New York",3921,1862,1094,190,598,1670,2251
360010302142,36085020100,"Census Tract 201, Richmond County, New York",3713,2721,182,344,305,1213,2500
360010302082,36085000800,"Census Tract 8, Richmond County, New York",5771,4240,207,654,383,1467,4304
361407001519,36085002002,"Census Tract 20.02, Richmond County, New York",3233,2606,11,553,5,167,3066
360010302174,36085002002,"Census Tract 20.02, Richmond County, New York",3233,2606,11,553,5,167,3066
360010302055,36085017600,"Census Tract 176, Richmond County, New York",4892,4689,1,194,0,170,4722
360010302165,36085017005,"Census Tract 170.05, Richmond County, New York",4744,4487,3,254,0,265,4479
360010301827,36085017700,"Census Tract 177, Richmond County, New York",6885,5736,70,960,7,590,6295
360008302135,36061023900,"Census Tract 239, New York County, New York",2526,623,1403,17,305,1201,1325
360008300152,36061028500,"Census Tract 285, New York County, New York",7808,1709,1010,107,4779,6845,963
360008305782,36061028500,"Census Tract 285, New York County, New York",7808,1709,1010,107,4779,6845,963
360008305784,36061028500,"Census Tract 285, New York County, New York",7808,1709,1010,107,4779,6845,963
360008301265,36061026900,"Census Tract 269, New York County, New York",9197,2330,686,128,5443,8206,991
360008302519,36061026900,"Census Tract 269, New York County, New York",9197,2330,686,128,5443,8206,991
360008305909,36061026900,"Census Tract 269, New York County, New York",9197,2330,686,128,5443,8206,991
360008305649,36061024301,"Census Tract 243.01, New York County, New York",4246,1181,1989,0,904,2003,2243
360008305648,36061024301,"Census Tract 243.01, New York County, New York",4246,1181,1989,0,904,2003,2243
360016705891,36061023700,"Census Tract 237, New York County, New York",7586,1927,2574,168,1061,4018,3568
360008302872,36061023700,"Census Tract 237, New York County, New York",7586,1927,2574,168,1061,4018,3568
360008305989,36061023700,"Census Tract 237, New York County, New York",7586,1927,2574,168,1061,4018,3568
360008301675,36061024500,"Census Tract 245, New York County, New York",15899,4538,2302,192,6099,12812,3087
360008302609,36061026300,"Census Tract 263, New York County, New York",9388,2539,847,99,5375,8025,1363
360008306099,36061026300,"Census Tract 263, New York County, New York",9388,2539,847,99,5375,8025,1363
360008301676,36061024900,"Census Tract 249, New York County, New York",1200,204,309,17,615,882,318
360008305647,36061024900,"Census Tract 249, New York County, New York",1200,204,309,17,615,882,318
360008305645,36061024900,"Census Tract 249, New York County, New York",1200,204,309,17,615,882,318
360008305646,36061024900,"Census Tract 249, New York County, New York",1200,204,309,17,615,882,318
360008302648,36061027700,"Census Tract 277, New York County, New York",7877,2519,1326,45,3722,6376,1501
360008303681,36061027700,"Census Tract 277, New York County, New York",7877,2519,1326,45,3722,6376,1501
360008303685,36061027700,"Census Tract 277, New York County, New York",7877,2519,1326,45,3722,6376,1501
360008303691,36061027700,"Census Tract 277, New York County, New York",7877,2519,1326,45,3722,6376,1501
360008305871,36061027700,"Census Tract 277, New York County, New York",7877,2519,1326,45,3722,6376,1501
360008303692,36061027700,"Census Tract 277, New York County, New York",7877,2519,1326,45,3722,6376,1501
360095206000,36061027700,"Census Tract 277, New York County, New York",7877,2519,1326,45,3722,6376,1501
360008100701,36061023600,"Census Tract 236, New York County, New York",6980,351,5935,86,504,1291,5689
360008102680,36061023600,"Census Tract 236, New York County, New York",6980,351,5935,86,504,1291,5689
360008105780,36061023600,"Census Tract 236, New York County, New York",6980,351,5935,86,504,1291,5689
360008102207,36061024302,"Census Tract 243.02, New York County, New York",6631,912,3778,167,1495,3232,3399
360008304451,36061029100,"Census Tract 291, New York County, New York",12189,2598,926,261,7837,11271,918
360008305643,36061029100,"Census Tract 291, New York County, New York",12189,2598,926,261,7837,11271,918
360008305644,36061029100,"Census Tract 291, New York County, New York",12189,2598,926,261,7837,11271,918
360008302374,36061030300,"Census Tract 303, New York County, New York",4397,2062,312,53,1625,2763,1634
360008704473,36061030900,"Census Tract 309, New York County, New York",9427,2545,2583,48,3869,6785,2642
360008705676,36061030900,"Census Tract 309, New York County, New York",9427,2545,2583,48,3869,6785,2642
360008705496,36061030900,"Census Tract 309, New York County, New York",9427,2545,2583,48,3869,6785,2642
360008702016,36061030900,"Census Tract 309, New York County, New York",9427,2545,2583,48,3869,6785,2642
360008705188,36061030900,"Census Tract 309, New York County, New York",9427,2545,2583,48,3869,6785,2642
360008705678,36061030900,"Census Tract 309, New York County, New York",9427,2545,2583,48,3869,6785,2642
360008706010,36061030900,"Census Tract 309, New York County, New York",9427,2545,2583,48,3869,6785,2642
360104106263,36061030900,"Census Tract 309, New York County, New York",9427,2545,2583,48,3869,6785,2642
360104706254,36061030900,"Census Tract 309, New York County, New York",9427,2545,2583,48,3869,6785,2642
360008300519,36061029900,"Census Tract 299, New York County, New York",4320,1025,914,0,2080,3437,883
360008300523,36061029900,"Census Tract 299, New York County, New York",4320,1025,914,0,2080,3437,883
360008305642,36061029900,"Census Tract 299, New York County, New York",4320,1025,914,0,2080,3437,883
360007702253,36061010800,"Census Tract 108, New York County, New York",8731,7289,177,1070,92,567,8164
360007701911,36061010800,"Census Tract 108, New York County, New York",8731,7289,177,1070,92,567,8164
360013500957,36085008100,"Census Tract 81, Richmond County, New York",4023,1813,1498,211,91,876,3147
360010302075,36085009602,"Census Tract 96.02, Richmond County, New York",3301,2877,11,338,61,372,2929
360010302247,36085004000,"Census Tract 40, Richmond County, New York",12744,4011,5361,1607,978,4460,8284
360010300962,36085004000,"Census Tract 40, Richmond County, New York",12744,4011,5361,1607,978,4460,8284
360010302214,36085005000,"Census Tract 50, Richmond County, New York",3608,2808,316,472,8,467,3141
360010302206,36085006400,"Census Tract 64, Richmond County, New York",3116,2065,706,267,0,540,2576
360010302159,36085004700,"Census Tract 47, Richmond County, New York",3603,2864,452,194,0,471,3132
360007802655,36061014700,"Census Tract 147, New York County, New York",2804,1895,57,683,67,170,2634
360007705112,36061005200,"Census Tract 52, New York County, New York",3792,2870,96,545,19,189,3603
360007700595,36061003700,"Census Tract 37, New York County, New York",2618,2260,50,223,52,135,2483
360007701934,36061003700,"Census Tract 37, New York County, New York",2618,2260,50,223,52,135,2483
360007706065,36061003700,"Census Tract 37, New York County, New York",2618,2260,50,223,52,135,2483
360010302196,36085023100,"Census Tract 231, Richmond County, New York",4183,1940,1142,644,291,1577,2606
360010303394,36085020801,"Census Tract 208.01, Richmond County, New York",9150,8588,157,396,0,887,8263
360008302658,36061022301,"Census Tract 223.01, New York County, New York",7954,2012,1054,383,2899,5852,2102
360008305783,36061022301,"Census Tract 223.01, New York County, New York",7954,2012,1054,383,2899,5852,2102
360010302035,36085011202,"Census Tract 112.02, Richmond County, New York",5924,5114,52,707,40,634,5290
360010302171,36085011202,"Census Tract 112.02, Richmond County, New York",5924,5114,52,707,40,634,5290
360010302046,36085011202,"Census Tract 112.02, Richmond County, New York",5924,5114,52,707,40,634,5290
360010302130,36085012500,"Census Tract 125, Richmond County, New York",2818,1700,855,90,105,804,2014
360010302201,36085012100,"Census Tract 121, Richmond County, New York",3270,2936,0,177,0,475,2795
360010304186,36085013400,"Census Tract 134, Richmond County, New York",3726,3458,0,147,121,590,3136
360010302220,36085013204,"Census Tract 132.04, Richmond County, New York",4814,4442,21,235,37,315,4499
360010302118,36085013800,"Census Tract 138, Richmond County, New York",6239,6176,61,2,0,544,5695
360010302120,36085013203,"Census Tract 132.03, Richmond County, New York",5556,5052,21,344,44,553,5003
360010302233,36085013203,"Census Tract 132.03, Richmond County, New York",5556,5052,21,344,44,553,5003
360013502864,36085002700,"Census Tract 27, Richmond County, New York",2362,917,577,205,558,958,1404
360010302861,36085000900,"Census Tract 9, Richmond County, New York",1962,668,946,16,271,693,1269
360010302146,36085000900,"Census Tract 9, Richmond County, New York",1962,668,946,16,271,693,1269
360010302186,36085012200,"Census Tract 122, Richmond County, New York",3591,3391,42,136,13,244,3347
360010302229,36085011201,"Census Tract 112.01, Richmond County, New York",5810,4946,0,744,75,655,5155
360010302052,36085017010,"Census Tract 170.10, Richmond County, New York",8923,8357,13,516,0,929,7994
360010304526,36085017010,"Census Tract 170.10, Richmond County, New York",8923,8357,13,516,0,929,7994
360010302107,36085020700,"Census Tract 207, Richmond County, New York",5503,2868,1632,128,739,3173,2330
360101906215,36085020700,"Census Tract 207, Richmond County, New York",5503,2868,1632,128,739,3173,2330
360010302113,36085030302,"Census Tract 303.02, Richmond County, New York",6205,2853,1574,889,564,2293,3912
360010302149,36085014608,"Census Tract 146.08, Richmond County, New York",3885,3607,0,278,0,602,3283
360010301973,36085006700,"Census Tract 67, Richmond County, New York",2580,2107,172,193,82,166,2414
360007705566,36061013900,"Census Tract 139, New York County, New York",7797,6139,330,843,244,693,7104
360007700116,36061013900,"Census Tract 139, New York County, New York",7797,6139,330,843,244,693,7104
360007702857,36061008300,"Census Tract 83, New York County, New York",4014,2465,385,431,306,762,3252
360007705539,36061008300,"Census Tract 83, New York County, New York",4014,2465,385,431,306,762,3252
360007702871,36061008300,"Census Tract 83, New York County, New York",4014,2465,385,431,306,762,3252
360007702152,36061009700,"Census Tract 97, New York County, New York",5148,3377,390,672,180,1531,3617
360013504807,36061019800,"Census Tract 198, New York County, New York",2465,590,1641,130,96,217,2248
360010805640,36061019800,"Census Tract 198, New York County, New York",2465,590,1641,130,96,217,2248
360008302550,36061023300,"Census Tract 233, New York County, New York",6734,1866,2900,222,678,2989,3745
360010302234,36085027302,"Census Tract 273.02, Richmond County, New York",3586,2638,166,665,75,258,3328
360010302257,36085029104,"Census Tract 291.04, Richmond County, New York",6999,5687,505,601,74,729,6270
360010301939,36085000700,"Census Tract 7, Richmond County, New York",6060,1918,2536,100,846,2291,3769
360010302110,36085021300,"Census Tract 213, Richmond County, New York",5163,2747,1000,532,531,1725,3438
360010302850,36085021300,"Census Tract 213, Richmond County, New York",5163,2747,1000,532,531,1725,3438
360010302097,36085010500,"Census Tract 105, Richmond County, New York",4986,3116,883,346,496,1624,3362
360007806115,36061015300,"Census Tract 153, New York County, New York",9025,7908,224,729,0,853,8172
360007701720,36061004800,"Census Tract 48, New York County, New York",7551,5293,437,1214,363,584,6967
360007700691,36061004800,"Census Tract 48, New York County, New York",7551,5293,437,1214,363,584,6967
360013502733,36061004800,"Census Tract 48, New York County, New York",7551,5293,437,1214,363,584,6967
360007704778,36061004800,"Census Tract 48, New York County, New York",7551,5293,437,1214,363,584,6967
360007702635,36061011600,"Census Tract 116, New York County, New York",3483,2429,441,304,16,190,3293
360007701949,36061009100,"Census Tract 91, New York County, New York",6559,4865,104,1108,58,429,6130
360007900638,36061017401,"Census Tract 174.01, New York County, New York",4330,1042,1831,457,945,1897,2433
360007905633,36061017401,"Census Tract 174.01, New York County, New York",4330,1042,1831,457,945,1897,2433
360007904448,36061017401,"Census Tract 174.01, New York County, New York",4330,1042,1831,457,945,1897,2433
360007902407,36061017401,"Census Tract 174.01, New York County, New York",4330,1042,1831,457,945,1897,2433
360104206252,36061017401,"Census Tract 174.01, New York County, New York",4330,1042,1831,457,945,1897,2433
360008102663,36061023200,"Census Tract 232, New York County, New York",8666,611,6517,202,879,2492,6174
360008005528,36061023200,"Census Tract 232, New York County, New York",8666,611,6517,202,879,2492,6174
360007701219,36061013800,"Census Tract 138, New York County, New York",12771,11278,173,897,16,924,11847
360007902324,36061018000,"Census Tract 180, New York County, New York",7717,1805,2435,565,2630,4407,3310
360007902387,36061018000,"Census Tract 180, New York County, New York",7717,1805,2435,565,2630,4407,3310
360007905530,36061018000,"Census Tract 180, New York County, New York",7717,1805,2435,565,2630,4407,3310
360007605618,36061003200,"Census Tract 32, New York County, New York",7802,6105,186,1133,247,623,7179
360007602270,36061003200,"Census Tract 32, New York County, New York",7802,6105,186,1133,247,623,7179
360007702480,36061004100,"Census Tract 41, New York County, New York",7581,2602,231,4480,138,359,7222
360013705766,36061001402,"Census Tract 14.02, New York County, New York",2666,1146,144,910,368,545,2121
360007602515,36061001402,"Census Tract 14.02, New York County, New York",2666,1146,144,910,368,545,2121
360007704356,36061002100,"Census Tract 21, New York County, New York",6506,4919,202,1023,19,194,6312
360008302431,36061026100,"Census Tract 261, New York County, New York",13686,3521,1414,331,7737,12242,1444
360010302189,36085017012,"Census Tract 170.12, Richmond County, New York",4526,4376,30,28,9,350,4176
360007902919,36061017200,"Census Tract 172, New York County, New York",5660,1948,1496,317,1815,3501,2159
360007902929,36061017200,"Census Tract 172, New York County, New York",5660,1948,1496,317,1815,3501,2159
360007905998,36061017200,"Census Tract 172, New York County, New York",5660,1948,1496,317,1815,3501,2159
360096206037,36061017200,"Census Tract 172, New York County, New York",5660,1948,1496,317,1815,3501,2159
360007700668,36061009500,"Census Tract 95, New York County, New York",3334,2419,133,613,0,158,3176
360017105932,36061003400,"Census Tract 34, New York County, New York",6673,5193,136,824,334,1245,5428
360007600695,36061003400,"Census Tract 34, New York County, New York",6673,5193,136,824,334,1245,5428
360016905862,36061019000,"Census Tract 190, New York County, New York",3010,560,1843,305,109,379,2631
360007802539,36061019000,"Census Tract 190, New York County, New York",3010,560,1843,305,109,379,2631
360103906260,36061019000,"Census Tract 190, New York County, New York",3010,560,1843,305,109,379,2631
360008302472,36061025100,"Census Tract 251, New York County, New York",2644,750,444,71,1140,1839,805
360007700586,36061011800,"Census Tract 118, New York County, New York",9464,8408,39,930,0,311,9153
360007700585,36061011800,"Census Tract 118, New York County, New York",9464,8408,39,930,0,311,9153
360007703646,36061011800,"Census Tract 118, New York County, New York",9464,8408,39,930,0,311,9153
360007701297,36061011800,"Census Tract 118, New York County, New York",9464,8408,39,930,0,311,9153
360007703348,36061011800,"Census Tract 118, New York County, New York",9464,8408,39,930,0,311,9153
360007700583,36061006300,"Census Tract 63, New York County, New York",6107,5223,79,469,45,290,5817
360007800619,36061018900,"Census Tract 189, New York County, New York",12331,4719,4617,580,2025,5346,6985
360007802525,36061018900,"Census Tract 189, New York County, New York",12331,4719,4617,580,2025,5346,6985
360008302643,36061027300,"Census Tract 273, New York County, New York",7020,5103,508,241,798,2037,4983
360007702076,36061008900,"Census Tract 89, New York County, New York",5614,4417,462,410,167,642,4972
360007702914,36061008900,"Census Tract 89, New York County, New York",5614,4417,462,410,167,642,4972
360007704401,36061008900,"Census Tract 89, New York County, New York",5614,4417,462,410,167,642,4972
360007704410,36061008900,"Census Tract 89, New York County, New York",5614,4417,462,410,167,642,4972
360007705772,36061008900,"Census Tract 89, New York County, New York",5614,4417,462,410,167,642,4972
360007706108,36061008900,"Census Tract 89, New York County, New York",5614,4417,462,410,167,642,4972
360007706193,36061008900,"Census Tract 89, New York County, New York",5614,4417,462,410,167,642,4972
360007702058,36061014200,"Census Tract 142, New York County, New York",4288,3944,14,94,39,318,3970
360007702039,36061007200,"Census Tract 72, New York County, New York",7500,5629,95,1016,291,523,6977
360007706207,36061007200,"Census Tract 72, New York County, New York",7500,5629,95,1016,291,523,6977
360007702885,36061005000,"Census Tract 50, New York County, New York",5238,4410,42,633,61,334,4904
360007706077,36061005000,"Census Tract 50, New York County, New York",5238,4410,42,633,61,334,4904
360007706105,36061005000,"Census Tract 50, New York County, New York",5238,4410,42,633,61,334,4904
360007706191,36061005000,"Census Tract 50, New York County, New York",5238,4410,42,633,61,334,4904
360007702468,36061002500,"Census Tract 25, New York County, New York",5291,991,534,2230,1240,2243,3048
360007702877,36061031703,"Census Tract 317.03, New York County, New York",8628,6460,81,1153,549,773,7855
360007703331,36061031703,"Census Tract 317.03, New York County, New York",8628,6460,81,1153,549,773,7855
360007703328,36061031703,"Census Tract 317.03, New York County, New York",8628,6460,81,1153,549,773,7855
360007703705,36061015601,"Census Tract 156.01, New York County, New York",5719,4402,366,835,50,748,4971
360013905776,36061022000,"Census Tract 220, New York County, New York",5577,968,3302,272,877,1084,4493
360007802308,36061022000,"Census Tract 220, New York County, New York",5577,968,3302,272,877,1084,4493
360007803551,36061022000,"Census Tract 220, New York County, New York",5577,968,3302,272,877,1084,4493
360007803550,36061021600,"Census Tract 216, New York County, New York",8421,1983,5505,115,566,1333,7088
360010905641,36061021600,"Census Tract 216, New York County, New York",8421,1983,5505,115,566,1333,7088
360095306018,36061021600,"Census Tract 216, New York County, New York",8421,1983,5505,115,566,1333,7088
360008305878,36061027100,"Census Tract 271, New York County, New York",9557,4835,578,343,3232,6339,3218
360008300528,36061027100,"Census Tract 271, New York County, New York",9557,4835,578,343,3232,6339,3218
360008300551,36061027100,"Census Tract 271, New York County, New York",9557,4835,578,343,3232,6339,3218
360008302485,36061027100,"Census Tract 271, New York County, New York",9557,4835,578,343,3232,6339,3218
360007605614,36061000201,"Census Tract 2.01, New York County, New York",2709,636,153,1334,549,882,1827
360007605616,36061000201,"Census Tract 2.01, New York County, New York",2709,636,153,1334,549,882,1827
360007605863,36061000201,"Census Tract 2.01, New York County, New York",2709,636,153,1334,549,882,1827
360007603508,36061000201,"Census Tract 2.01, New York County, New York",2709,636,153,1334,549,882,1827
360007704729,36061014402,"Census Tract 144.02, New York County, New York",7537,6414,313,611,0,262,7275
360007602411,36061001200,"Census Tract 12, New York County, New York",3552,1893,155,838,587,1019,2533
360007702047,36061000600,"Census Tract 6, New York County, New York",11354,1418,1033,6189,2462,3500,7854
360008304872,36061028300,"Census Tract 283, New York County, New York",7879,3650,673,364,2735,5342,2537
360008305990,36061028300,"Census Tract 283, New York County, New York",7879,3650,673,364,2735,5342,2537
360008302546,36061028300,"Census Tract 283, New York County, New York",7879,3650,673,364,2735,5342,2537
360102406241,36061028300,"Census Tract 283, New York County, New York",7879,3650,673,364,2735,5342,2537
360007605621,36061001002,"Census Tract 10.02, New York County, New York",6174,1812,1303,562,2136,4130,2044
360007700692,36061001300,"Census Tract 13, New York County, New York",4167,3065,134,739,83,454,3713
360005304411,36061001300,"Census Tract 13, New York County, New York",4167,3065,134,739,83,454,3713
360007700700,36061001300,"Census Tract 13, New York County, New York",4167,3065,134,739,83,454,3713
360007603680,36061000202,"Census Tract 2.02, New York County, New York",8308,3667,957,2059,1240,3168,5140
360007602492,36061000202,"Census Tract 2.02, New York County, New York",8308,3667,957,2059,1240,3168,5140
360007602502,36061000202,"Census Tract 2.02, New York County, New York",8308,3667,957,2059,1240,3168,5140
360007705085,36061000900,"Census Tract 9, New York County, New York",1396,1116,32,118,84,154,1242
360007705764,36061000900,"Census Tract 9, New York County, New York",1396,1116,32,118,84,154,1242
360007706178,36061000900,"Census Tract 9, New York County, New York",1396,1116,32,118,84,154,1242
360008502547,36005005200,"Census Tract 52, Bronx County, New York",2128,371,564,53,881,1524,604
360009002219,36005015700,"Census Tract 157, Bronx County, New York",3761,270,1434,15,1826,2322,1439
360009005509,36005015700,"Census Tract 157, Bronx County, New York",3761,270,1434,15,1826,2322,1439
360009005806,36005015700,"Census Tract 157, Bronx County, New York",3761,270,1434,15,1826,2322,1439
360009001327,36005015700,"Census Tract 157, Bronx County, New York",3761,270,1434,15,1826,2322,1439
360009401921,36047027100,"Census Tract 271, Kings County, New York",2663,179,2164,237,43,113,2550
360009202088,36047005300,"Census Tract 53, Kings County, New York",2506,1307,293,76,671,887,1619
360009205243,36047005300,"Census Tract 53, Kings County, New York",2506,1307,293,76,671,887,1619
360094906082,36047005300,"Census Tract 53, Kings County, New York",2506,1307,293,76,671,887,1619
360012005895,36047105804,"Census Tract 1058.04, Kings County, New York",6200,1933,3399,221,461,1380,4820
360012002855,36047105804,"Census Tract 1058.04, Kings County, New York",6200,1933,3399,221,461,1380,4820
360012002006,36047105804,"Census Tract 1058.04, Kings County, New York",6200,1933,3399,221,461,1380,4820
360101406171,36047105804,"Census Tract 1058.04, Kings County, New York",6200,1933,3399,221,461,1380,4820
360015202731,36047061004,"Census Tract 610.04, Kings County, New York",6255,5764,133,309,18,361,5894
360013504815,36047061004,"Census Tract 610.04, Kings County, New York",6255,5764,133,309,18,361,5894
360015302007,36047069602,"Census Tract 696.02, Kings County, New York",6339,3957,1527,349,368,960,5379
360015302814,36047069602,"Census Tract 696.02, Kings County, New York",6339,3957,1527,349,368,960,5379
360008602133,36005023302,"Census Tract 233.02, Bronx County, New York",3247,624,866,13,1677,2496,751
360008702939,36005023900,"Census Tract 239, Bronx County, New York",8347,553,1927,150,5470,6468,1879
360008702155,36005023900,"Census Tract 239, Bronx County, New York",8347,553,1927,150,5470,6468,1879
360008704731,36005024900,"Census Tract 249, Bronx County, New York",0,0,0,0,0,0,0
360008400749,36005024900,"Census Tract 249, Bronx County, New York",0,0,0,0,0,0,0
360008704310,36005025300,"Census Tract 253, Bronx County, New York",5970,567,1270,258,3561,4327,1643
360008701748,36005025500,"Census Tract 255, Bronx County, New York",5764,530,1423,50,3391,4302,1462
360008701306,36005025500,"Census Tract 255, Bronx County, New York",5764,530,1423,50,3391,4302,1462
360008502293,36005026602,"Census Tract 266.02, Bronx County, New York",5488,3105,343,89,1613,2593,2895
360008703805,36005027300,"Census Tract 273, Bronx County, New York",8429,1297,1856,193,4305,6542,1887
360008705798,36005027300,"Census Tract 273, Bronx County, New York",8429,1297,1856,193,4305,6542,1887
360008705677,36005027300,"Census Tract 273, Bronx County, New York",8429,1297,1856,193,4305,6542,1887
360008702210,36005026900,"Census Tract 269, Bronx County, New York",3318,568,443,226,1966,2491,827
360008704693,36005028900,"Census Tract 289, Bronx County, New York",4027,1682,246,231,1583,2577,1450
360102606235,36005028900,"Census Tract 289, Bronx County, New York",4027,1682,246,231,1583,2577,1450
360016305923,36005028300,"Census Tract 283, Bronx County, New York",3390,535,957,13,1752,2408,982
360104906265,36005029600,"Census Tract 296, Bronx County, New York",1842,749,368,412,279,412,1430
360013501923,36005028400,"Census Tract 284, Bronx County, New York",707,118,274,18,262,286,421
360008801935,36005032400,"Census Tract 324, Bronx County, New York",2798,668,805,9,1142,1695,1103
360008805685,36005032400,"Census Tract 324, Bronx County, New York",2798,668,805,9,1142,1695,1103
360008802342,36005032400,"Census Tract 324, Bronx County, New York",2798,668,805,9,1142,1695,1103
360008805559,36005032400,"Census Tract 324, Bronx County, New York",2798,668,805,9,1142,1695,1103
360008805541,36005032400,"Census Tract 324, Bronx County, New York",2798,668,805,9,1142,1695,1103
360008805687,36005032400,"Census Tract 324, Bronx County, New York",2798,668,805,9,1142,1695,1103
360008806245,36005032400,"Census Tract 324, Bronx County, New York",2798,668,805,9,1142,1695,1103
360008806270,36005032400,"Census Tract 324, Bronx County, New York",2798,668,805,9,1142,1695,1103
360008802573,36005030200,"Census Tract 302, Bronx County, New York",9914,957,6603,55,1972,2298,7616
360100506110,36005030200,"Census Tract 302, Bronx County, New York",9914,957,6603,55,1972,2298,7616
360008802524,36005031000,"Census Tract 310, Bronx County, New York",4863,2305,867,672,873,1387,3476
360008805804,36005031000,"Census Tract 310, Bronx County, New York",4863,2305,867,672,873,1387,3476
360008802306,36005034200,"Census Tract 342, Bronx County, New York",1947,320,987,135,453,691,1256
360008802111,36005040600,"Census Tract 406, Bronx County, New York",3377,281,2564,48,360,624,2753
360008704464,36005040100,"Census Tract 401, Bronx County, New York",5457,694,686,88,3831,4618,839
360008702150,36005039100,"Census Tract 391, Bronx County, New York",7201,2065,941,25,3856,5053,2148
360008702691,36005039300,"Census Tract 393, Bronx County, New York",7781,702,2093,37,4637,5476,2305
360008701958,36005039300,"Census Tract 393, Bronx County, New York",7781,702,2093,37,4637,5476,2305
360013504469,36005039300,"Census Tract 393, Bronx County, New York",7781,702,2093,37,4637,5476,2305
360008706247,36005039300,"Census Tract 393, Bronx County, New York",7781,702,2093,37,4637,5476,2305
360008703794,36005038700,"Census Tract 387, Bronx County, New York",3023,905,747,54,1147,1756,1267
360008705182,36005038700,"Census Tract 387, Bronx County, New York",3023,905,747,54,1147,1756,1267
360008705183,36005038700,"Census Tract 387, Bronx County, New York",3023,905,747,54,1147,1756,1267
360008705184,36005038700,"Census Tract 387, Bronx County, New York",3023,905,747,54,1147,1756,1267
360008705185,36005038700,"Census Tract 387, Bronx County, New York",3023,905,747,54,1147,1756,1267
360008705674,36005038700,"Census Tract 387, Bronx County, New York",3023,905,747,54,1147,1756,1267
360008705943,36005038700,"Census Tract 387, Bronx County, New York",3023,905,747,54,1147,1756,1267
360008702202,36005038700,"Census Tract 387, Bronx County, New York",3023,905,747,54,1147,1756,1267
360008705796,36005037900,"Census Tract 379, Bronx County, New York",5225,687,2556,34,1800,2744,2481
360008703812,36005037900,"Census Tract 379, Bronx County, New York",5225,687,2556,34,1800,2744,2481
360008602583,36005037900,"Census Tract 379, Bronx County, New York",5225,687,2556,34,1800,2744,2481
360008704353,36005038500,"Census Tract 385, Bronx County, New York",5030,732,1493,0,2704,3635,1395
360008802312,36005038600,"Census Tract 386, Bronx County, New York",7448,278,5771,245,1059,1308,6140
360010205948,36081006900,"Census Tract 69, Queens County, New York",4696,2901,123,846,577,1366,3330
360009802038,36081046100,"Census Tract 461, Queens County, New York",3341,897,17,1806,567,1301,2040
360009802340,36081058500,"Census Tract 585, Queens County, New York",4630,3989,52,375,85,2196,2434
360010001414,36081023600,"Census Tract 236, Queens County, New York",2537,684,308,968,474,957,1580
360010001951,36081074700,"Census Tract 747, Queens County, New York",3193,1251,328,1410,105,353,2840
360012302208,36081107201,"Census Tract 1072.01, Queens County, New York",2058,2043,3,6,0,104,1954
360009802103,36081040900,"Census Tract 409, Queens County, New York",5407,1708,254,755,1999,4539,868
360012306036,36081002000,"Census Tract 20, Queens County, New York",1861,486,80,513,653,966,895
360012202105,36081085500,"Census Tract 855, Queens County, New York",6525,1240,238,4431,418,1244,5281
360005704804,36081005700,"Census Tract 57, Queens County, New York",4566,2639,205,694,801,2022,2544
360010202594,36081005700,"Census Tract 57, Queens County, New York",4566,2639,205,694,801,2022,2544
360010204894,36081005700,"Census Tract 57, Queens County, New York",4566,2639,205,694,801,2022,2544
360010005297,36081024600,"Census Tract 246, Queens County, New York",0,0,0,0,0,0,0
360010106220,36081048000,"Census Tract 480, Queens County, New York",2877,335,655,1127,509,628,2249
360012305883,36081097202,"Census Tract 972.02, Queens County, New York",2407,904,1416,5,40,758,1649
360009804895,36081017900,"Census Tract 179, Queens County, New York",1039,753,17,188,54,463,576
360009805828,36081017900,"Census Tract 179, Queens County, New York",1039,753,17,188,54,463,576
360009805829,36081017900,"Census Tract 179, Queens County, New York",1039,753,17,188,54,463,576
360009804896,36081017900,"Census Tract 179, Queens County, New York",1039,753,17,188,54,463,576
360009801915,36081017900,"Census Tract 179, Queens County, New York",1039,753,17,188,54,463,576
360009806004,36081017900,"Census Tract 179, Queens County, New York",1039,753,17,188,54,463,576
360010002881,36081045200,"Census Tract 452, Queens County, New York",974,366,251,346,11,109,865
360010002008,36081045200,"Census Tract 452, Queens County, New York",974,366,251,346,11,109,865
360010006174,36081045200,"Census Tract 452, Queens County, New York",974,366,251,346,11,109,865
360010006213,36081045200,"Census Tract 452, Queens County, New York",974,366,251,346,11,109,865
360010006005,36081045200,"Census Tract 452, Queens County, New York",974,366,251,346,11,109,865
360010006283,36081045200,"Census Tract 452, Queens County, New York",974,366,251,346,11,109,865
360010002236,36081014201,"Census Tract 142.01, Queens County, New York",4347,1063,235,1610,1040,2113,2234
360009902709,36081137700,"Census Tract 1377, Queens County, New York",6373,2237,73,3818,95,279,6094
360010203123,36081000100,"Census Tract 1, Queens County, New York",5928,4072,309,1208,87,372,5556
360012302369,36081001200,"Census Tract 12, Queens County, New York",4830,2730,352,731,815,2795,2035
360012305729,36081002400,"Census Tract 24, Queens County, New York",2353,1034,252,474,566,1218,1135
360012302278,36081002400,"Census Tract 24, Queens County, New York",2353,1034,252,474,566,1218,1135
360012306195,36081002800,"Census Tract 28, Queens County, New York",2782,1147,217,369,732,1497,1285
360012302259,36081001800,"Census Tract 18, Queens County, New York",3403,1223,300,717,1032,1974,1429
360010205511,36081001900,"Census Tract 19, Queens County, New York",1343,763,30,341,193,291,1052
360010102497,36081052000,"Census Tract 520, Queens County, New York",1765,58,1626,8,47,119,1646
360010005832,36081046000,"Census Tract 460, Queens County, New York",5979,603,971,2313,1656,2046,3933
360010202071,36081015100,"Census Tract 151, Queens County, New York",2700,2223,5,341,40,333,2367
360005904803,36081028300,"Census Tract 283, Queens County, New York",6619,4123,270,1125,952,3799,2820
360010204785,36081028300,"Census Tract 283, Queens County, New York",6619,4123,270,1125,952,3799,2820
360012305899,36081011400,"Census Tract 114, Queens County, New York",937,466,183,34,162,522,415
360010202688,36081005100,"Census Tract 51, Queens County, New York",2106,762,82,1034,189,333,1773
360010206070,36081005100,"Census Tract 51, Queens County, New York",2106,762,82,1034,189,333,1773
360010205735,36081005500,"Census Tract 55, Queens County, New York",1125,496,26,175,361,584,541
360010002437,36081023200,"Census Tract 232, Queens County, New York",5670,1445,641,2168,1027,1413,4257
360010002718,36081023200,"Census Tract 232, Queens County, New York",5670,1445,641,2168,1027,1413,4257
360009802081,36081045700,"Census Tract 457, Queens County, New York",3089,598,18,1946,489,869,2220
360009802349,36081062500,"Census Tract 625, Queens County, New York",2377,2135,49,123,68,404,1973
360012302345,36081012800,"Census Tract 128, Queens County, New York",2070,973,183,222,623,1049,1021
360009804146,36081040300,"Census Tract 403, Queens County, New York",7250,3325,301,396,2866,6577,673
360012302516,36081004002,"Census Tract 40.02, Queens County, New York",1461,274,54,613,392,437,1024
360010202328,36081011900,"Census Tract 119, Queens County, New York",1712,1337,20,143,174,393,1319
360010202527,36081028500,"Census Tract 285, Queens County, New York",4944,3569,78,864,417,2125,2819
360010202535,36081007300,"Census Tract 73, Queens County, New York",4452,3223,54,893,200,1251,3201
360010205553,36081007300,"Census Tract 73, Queens County, New York",4452,3223,54,893,200,1251,3201
360010002567,36081072100,"Census Tract 721, Queens County, New York",4543,3005,29,1130,313,872,3671
360010002614,36081072100,"Census Tract 721, Queens County, New York",4543,3005,29,1130,313,872,3671
360012304352,36081013000,"Census Tract 130, Queens County, New York",1510,795,140,308,232,420,1090
360010102153,36081056000,"Census Tract 560, Queens County, New York",1431,402,271,518,148,245,1186
360010202352,36081037700,"Census Tract 377, Queens County, New York",3552,1128,594,141,1632,2935,617
360013502859,36081068300,"Census Tract 683, Queens County, New York",4589,2235,189,1802,238,2168,2421
360010102438,36081050400,"Census Tract 504, Queens County, New York",2034,88,1791,0,125,169,1865
360007805524,36061025700,"Census Tract 257, New York County, New York",4470,1312,2211,380,469,801,3669
360102306232,36061025700,"Census Tract 257, New York County, New York",4470,1312,2211,380,469,801,3669
360008105637,36061024200,"Census Tract 242, New York County, New York",3709,649,1875,168,825,1864,1845
360013504780,36061024200,"Census Tract 242, New York County, New York",3709,649,1875,168,825,1864,1845
360008102141,36061024200,"Census Tract 242, New York County, New York",3709,649,1875,168,825,1864,1845
360095406017,36061024200,"Census Tract 242, New York County, New York",3709,649,1875,168,825,1864,1845
360015202715,36047037401,"Census Tract 374.01, Kings County, New York",4177,3738,65,200,0,203,3974
360013502826,36047035602,"Census Tract 356.02, Kings County, New York",4580,4525,54,0,1,65,4515
360015202378,36047035602,"Census Tract 356.02, Kings County, New York",4580,4525,54,0,1,65,4515
360009105812,36047001500,"Census Tract 15, Kings County, New York",5240,2187,1188,1042,646,1097,4143
360009100867,36047001500,"Census Tract 15, Kings County, New York",5240,2187,1188,1042,646,1097,4143
360009101371,36047001500,"Census Tract 15, Kings County, New York",5240,2187,1188,1042,646,1097,4143
360015302852,36047068000,"Census Tract 680, Kings County, New York",2031,306,1438,99,185,418,1613
360015302697,36047065200,"Census Tract 652, Kings County, New York",1277,1043,63,124,22,17,1260
360015302752,36047069800,"Census Tract 698, Kings County, New York",1373,1181,0,92,86,152,1221
360015302012,36047066600,"Census Tract 666, Kings County, New York",0,0,0,0,0,0,0
360015302854,36047066600,"Census Tract 666, Kings County, New York",0,0,0,0,0,0,0
360015302853,36047072200,"Census Tract 722, Kings County, New York",3111,26,2977,23,16,104,3007
360009202482,36047022400,"Census Tract 224, Kings County, New York",6057,4325,100,568,1032,1424,4633
360015102575,36047022000,"Census Tract 220, Kings County, New York",5000,4416,14,408,162,343,4657
360009102050,36047022700,"Census Tract 227, Kings County, New York",3449,723,2237,184,223,456,2993
360004504493,36047025901,"Census Tract 259.01, Kings County, New York",1574,582,736,77,163,621,953
360011902116,36047025901,"Census Tract 259.01, Kings County, New York",1574,582,736,77,163,621,953
360009105962,36047023500,"Census Tract 235, Kings County, New York",4306,2861,819,188,389,949,3357
360009105968,36047023500,"Census Tract 235, Kings County, New York",4306,2861,819,188,389,949,3357
360009106029,36047023500,"Census Tract 235, Kings County, New York",4306,2861,819,188,389,949,3357
360015102212,36047024400,"Census Tract 244, Kings County, New York",3523,2577,13,577,356,637,2886
360017205868,36047025100,"Census Tract 251, Kings County, New York",3256,282,2598,91,102,316,2940
360015102692,36047025600,"Census Tract 256, Kings County, New York",3243,1240,0,1940,18,319,2924
360015102729,36047023000,"Census Tract 230, Kings County, New York",4213,3328,60,217,545,837,3376
360015105955,36047023000,"Census Tract 230, Kings County, New York",4213,3328,60,217,545,837,3376
360009105694,36047023100,"Census Tract 231, Kings County, New York",3434,1616,1259,188,166,216,3218
360009102243,36047023100,"Census Tract 231, Kings County, New York",3434,1616,1259,188,166,216,3218
360009102772,36047025300,"Census Tract 253, Kings County, New York",2346,674,1264,152,231,541,1805
360011905813,36047025700,"Census Tract 257, Kings County, New York",1997,473,801,59,508,947,1050
360011905816,36047025700,"Census Tract 257, Kings County, New York",1997,473,801,59,508,947,1050
360011902804,36047025700,"Census Tract 257, Kings County, New York",1997,473,801,59,508,947,1050
360013502020,36047025700,"Census Tract 257, Kings County, New York",1997,473,801,59,508,947,1050
360013500806,36047025700,"Census Tract 257, Kings County, New York",1997,473,801,59,508,947,1050
360105406295,36047025700,"Census Tract 257, Kings County, New York",1997,473,801,59,508,947,1050
360015102735,36047025000,"Census Tract 250, Kings County, New York",1575,433,33,1026,68,131,1444
360015302443,36047073400,"Census Tract 734, Kings County, New York",2416,104,2177,0,65,115,2301
360009502725,36047035500,"Census Tract 355, Kings County, New York",4952,628,3899,0,425,532,4420
360015202346,36047035000,"Census Tract 350, Kings County, New York",2812,2732,0,52,0,0,2812
360009502656,36047035900,"Census Tract 359, Kings County, New York",5068,106,4653,39,246,734,4334
360015205826,36047035400,"Census Tract 354, Kings County, New York",5082,5042,40,0,0,0,5082
360015201906,36047035400,"Census Tract 354, Kings County, New York",5082,5042,40,0,0,0,5082
360015202807,36047035400,"Census Tract 354, Kings County, New York",5082,5042,40,0,0,0,5082
360015302755,36047074800,"Census Tract 748, Kings County, New York",1787,1357,357,0,73,100,1687
360009606152,36047098400,"Census Tract 984, Kings County, New York",2243,53,2143,39,0,51,2192
360009606155,36047098400,"Census Tract 984, Kings County, New York",2243,53,2143,39,0,51,2192
360009601930,36047099000,"Census Tract 990, Kings County, New York",1582,15,1444,12,81,75,1507
360009606023,36047099000,"Census Tract 990, Kings County, New York",1582,15,1444,12,81,75,1507
360009606052,36047099000,"Census Tract 990, Kings County, New York",1582,15,1444,12,81,75,1507
360009606059,36047099000,"Census Tract 990, Kings County, New York",1582,15,1444,12,81,75,1507
360009602791,36047098600,"Census Tract 986, Kings County, New York",3419,80,3146,67,93,211,3208
360009605506,36047097000,"Census Tract 970, Kings County, New York",1877,323,1448,39,67,193,1684
360009602427,36047096400,"Census Tract 964, Kings County, New York",2569,99,1823,38,517,598,1971
360105206271,36047096400,"Census Tract 964, Kings County, New York",2569,99,1823,38,517,598,1971
360009602429,36047100800,"Census Tract 1008, Kings County, New York",2036,269,1590,103,57,112,1924
360009606009,36047097400,"Census Tract 974, Kings County, New York",3297,288,2610,87,312,401,2896
360100306159,36047074600,"Census Tract 746, Kings County, New York",2207,1522,524,121,6,196,2011
360010301974,36085027706,"Census Tract 277.06, Richmond County, New York",3320,2299,258,594,83,457,2863
360010302878,36085018100,"Census Tract 181, Richmond County, New York",3049,2806,27,189,7,386,2663
360011902255,36047028502,"Census Tract 285.02, Kings County, New York",2552,363,1783,0,312,944,1608
360009102195,36047027700,"Census Tract 277, Kings County, New York",4584,167,4301,0,107,351,4233
360009405518,36047029100,"Census Tract 291, Kings County, New York",3252,396,2653,26,135,360,2892
360009404059,36047029100,"Census Tract 291, Kings County, New York",3252,396,2653,26,135,360,2892
360009402128,36047029100,"Census Tract 291, Kings County, New York",3252,396,2653,26,135,360,2892
360009402499,36047029100,"Census Tract 291, Kings County, New York",3252,396,2653,26,135,360,2892
360009406122,36047029100,"Census Tract 291, Kings County, New York",3252,396,2653,26,135,360,2892
360009405904,36047028100,"Census Tract 281, Kings County, New York",5087,1448,2706,49,784,2155,2932
360009402123,36047028100,"Census Tract 281, Kings County, New York",5087,1448,2706,49,784,2155,2932
360009406049,36047028100,"Census Tract 281, Kings County, New York",5087,1448,2706,49,784,2155,2932
360009406061,36047028100,"Census Tract 281, Kings County, New York",5087,1448,2706,49,784,2155,2932
360009100847,36047026700,"Census Tract 267, Kings County, New York",3397,553,2531,84,79,340,3057
360009105563,36047026700,"Census Tract 267, Kings County, New York",3397,553,2531,84,79,340,3057
360015202473,36047028800,"Census Tract 288, Kings County, New York",3041,1567,7,1149,304,291,2750
360015203107,36047028800,"Census Tract 288, Kings County, New York",3041,1567,7,1149,304,291,2750
360015102641,36047027400,"Census Tract 274, Kings County, New York",2786,1424,6,1356,0,105,2681
360009404053,36047029300,"Census Tract 293, Kings County, New York",3219,167,2504,9,355,704,2515
360009402812,36047029300,"Census Tract 293, Kings County, New York",3219,167,2504,9,355,704,2515
360096106071,36047029300,"Census Tract 293, Kings County, New York",3219,167,2504,9,355,704,2515
360096506044,36047029300,"Census Tract 293, Kings County, New York",3219,167,2504,9,355,704,2515
360104806255,36047029300,"Census Tract 293, Kings County, New York",3219,167,2504,9,355,704,2515
360009402779,36047029700,"Census Tract 297, Kings County, New York",3895,275,3202,143,13,204,3691
360009405927,36047037900,"Census Tract 379, Kings County, New York",3412,144,3102,0,116,212,3200
360009402178,36047037900,"Census Tract 379, Kings County, New York",3412,144,3102,0,116,212,3200
360012105721,36047036501,"Census Tract 365.01, Kings County, New York",2624,123,2332,28,136,201,2423
360096906014,36047036501,"Census Tract 365.01, Kings County, New York",2624,123,2332,28,136,201,2423
360011605708,36047038700,"Census Tract 387, Kings County, New York",3951,743,2695,325,156,850,3101
360009402054,36047037700,"Census Tract 377, Kings County, New York",4123,383,3227,145,250,528,3595
360012102501,36047037300,"Census Tract 373, Kings County, New York",3918,367,2735,48,718,905,3013
360011902445,36047038900,"Census Tract 389, Kings County, New York",3331,1171,197,198,1330,2329,1002
360009404079,36047037500,"Census Tract 375, Kings County, New York",3228,362,2581,95,117,542,2686
360012102299,36047036900,"Census Tract 369, Kings County, New York",4785,355,3343,37,957,1316,3469
360012102559,36047036900,"Census Tract 369, Kings County, New York",4785,355,3343,37,957,1316,3469
360009702788,36047039300,"Census Tract 393, Kings County, New York",3768,1673,1633,69,269,2157,1611
360009705562,36047039300,"Census Tract 393, Kings County, New York",3768,1673,1633,69,269,2157,1611
360009700827,36047039300,"Census Tract 393, Kings County, New York",3768,1673,1633,69,269,2157,1611
360015202702,36047037000,"Census Tract 370, Kings County, New York",4085,2763,9,1196,21,229,3856
360015202767,36047036400,"Census Tract 364, Kings County, New York",2126,1305,41,630,146,308,1818
360015202888,36047036600,"Census Tract 366, Kings County, New York",4433,2447,265,1302,359,1130,3303
360015300829,36047077200,"Census Tract 772, Kings County, New York",3223,1499,1506,30,121,239,2984
360015302032,36047077200,"Census Tract 772, Kings County, New York",3223,1499,1506,30,121,239,2984
360015303385,36047077200,"Census Tract 772, Kings County, New York",3223,1499,1506,30,121,239,2984
360015302549,36047077200,"Census Tract 772, Kings County, New York",3223,1499,1506,30,121,239,2984
360009501908,36047031100,"Census Tract 311, Kings County, New York",2829,257,2490,21,34,233,2596
360009506273,36047031100,"Census Tract 311, Kings County, New York",2829,257,2490,21,34,233,2596
360012100857,36047036700,"Census Tract 367, Kings County, New York",1285,136,733,33,333,488,797
360012105994,36047036700,"Census Tract 367, Kings County, New York",1285,136,733,33,333,488,797
360015205940,36047030600,"Census Tract 306, Kings County, New York",2019,1025,0,855,107,167,1852
360015205827,36047030600,"Census Tract 306, Kings County, New York",2019,1025,0,855,107,167,1852
360015205941,36047030600,"Census Tract 306, Kings County, New York",2019,1025,0,855,107,167,1852
360012105724,36047030100,"Census Tract 301, Kings County, New York",2784,69,2388,248,67,97,2687
360009405519,36047030100,"Census Tract 301, Kings County, New York",2784,69,2388,248,67,97,2687
360103206229,36047030100,"Census Tract 301, Kings County, New York",2784,69,2388,248,67,97,2687
360012106078,36047030100,"Census Tract 301, Kings County, New York",2784,69,2388,248,67,97,2687
360009405707,36047030700,"Census Tract 307, Kings County, New York",4288,65,3394,45,632,1046,3242
360009402823,36047030700,"Census Tract 307, Kings County, New York",4288,65,3394,45,632,1046,3242
360009202251,36047007700,"Census Tract 77, Kings County, New York",4352,3273,104,398,324,626,3726
360015202792,36047030400,"Census Tract 304, Kings County, New York",3984,2141,40,1641,89,267,3717
360015202708,36047031400,"Census Tract 314, Kings County, New York",4201,3221,97,850,33,308,3893
360013501927,36047030800,"Census Tract 308, Kings County, New York",2146,1699,8,355,53,424,1722
360015204312,36047030800,"Census Tract 308, Kings County, New York",2146,1699,8,355,53,424,1722
360009502504,36047031701,"Census Tract 317.01, Kings County, New York",3128,569,2296,121,52,123,3005
360099406151,36047031701,"Census Tract 317.01, Kings County, New York",3128,569,2296,121,52,123,3005
360009502798,36047034100,"Census Tract 341, Kings County, New York",2643,268,2016,0,219,222,2421
360009505817,36047034300,"Census Tract 343, Kings County, New York",5026,235,3460,223,1017,1320,3706
360009505820,36047034300,"Census Tract 343, Kings County, New York",5026,235,3460,223,1017,1320,3706
360014805822,36047034300,"Census Tract 343, Kings County, New York",5026,235,3460,223,1017,1320,3706
360009502576,36047031900,"Census Tract 319, Kings County, New York",3652,569,3065,9,0,254,3398
360015202382,36047030200,"Census Tract 302, Kings County, New York",4445,1356,41,2868,125,249,4196
360015205823,36047030200,"Census Tract 302, Kings County, New York",4445,1356,41,2868,125,249,4196
360015205926,36047030200,"Census Tract 302, Kings County, New York",4445,1356,41,2868,125,249,4196
360015202821,36047034200,"Census Tract 342, Kings County, New York",5694,2176,2139,233,875,1324,4370
360015202797,36047034200,"Census Tract 342, Kings County, New York",5694,2176,2139,233,875,1324,4370
360015202645,36047032800,"Census Tract 328, Kings County, New York",2363,340,928,946,91,303,2060
360015202754,36047033000,"Census Tract 330, Kings County, New York",4331,1427,2066,185,569,1381,2950
360015202713,36047041401,"Census Tract 414.01, Kings County, New York",1265,1136,0,90,39,64,1201
360009702803,36047041300,"Census Tract 413, Kings County, New York",3895,1325,1607,32,718,2232,1663
360009702806,36047039900,"Census Tract 399, Kings County, New York",3680,1214,1943,33,382,1856,1824
360015202363,36047039800,"Census Tract 398, Kings County, New York",2699,1341,0,1000,277,538,2161
360009702829,36047041500,"Census Tract 415, Kings County, New York",4238,1744,1973,99,268,2463,1775
360009702304,36047041900,"Census Tract 419, Kings County, New York",4048,1995,1228,45,468,2660,1388
360009702334,36047043100,"Census Tract 431, Kings County, New York",5695,2208,693,727,1999,4091,1604
360009701789,36047043100,"Census Tract 431, Kings County, New York",5695,2208,693,727,1999,4091,1604
360009702000,36047043100,"Census Tract 431, Kings County, New York",5695,2208,693,727,1999,4091,1604
360009704887,36047042300,"Census Tract 423, Kings County, New York",4851,2949,834,243,662,3567,1284
360009704888,36047042300,"Census Tract 423, Kings County, New York",4851,2949,834,243,662,3567,1284
360009702526,36047042500,"Census Tract 425, Kings County, New York",2665,1047,372,57,1071,1836,829
360015106138,36047042800,"Census Tract 428, Kings County, New York",4036,2667,30,1155,176,390,3646
360015106120,36047042800,"Census Tract 428, Kings County, New York",4036,2667,30,1155,176,390,3646
360015202367,36047043000,"Census Tract 430, Kings County, New York",3080,1676,0,1257,147,412,2668
360015101348,36047021200,"Census Tract 212, Kings County, New York",5130,1272,22,3680,0,172,4958
360009602707,36047098800,"Census Tract 988, Kings County, New York",3086,243,2676,22,111,164,2922
360015105877,36047007400,"Census Tract 74, Kings County, New York",5633,1488,233,1178,2634,4035,1598
360015105908,36047007400,"Census Tract 74, Kings County, New York",5633,1488,233,1178,2634,4035,1598
360009500882,36047032100,"Census Tract 321, Kings County, New York",5898,1090,4441,124,215,838,5060
360015302783,36047078800,"Census Tract 788, Kings County, New York",3524,96,3061,51,238,359,3165
360015302003,36047059600,"Census Tract 596, Kings County, New York",2416,2274,38,80,24,85,2331
360013501926,36047059600,"Census Tract 596, Kings County, New York",2416,2274,38,80,24,85,2331
360015304885,36047072800,"Census Tract 728, Kings County, New York",3733,268,3299,76,19,88,3645
360015101952,36047004600,"Census Tract 46, Kings County, New York",1396,1238,9,89,37,118,1278
360009702582,36047044500,"Census Tract 445, Kings County, New York",4825,2367,374,626,1223,2916,1909
360009702457,36047044500,"Census Tract 445, Kings County, New York",4825,2367,374,626,1223,2916,1909
360009705552,36047043500,"Census Tract 435, Kings County, New York",5161,2440,1736,102,739,3834,1327
360009705866,36047043500,"Census Tract 435, Kings County, New York",5161,2440,1736,102,739,3834,1327
360009702400,36047043500,"Census Tract 435, Kings County, New York",5161,2440,1736,102,739,3834,1327
360009705555,36047043500,"Census Tract 435, Kings County, New York",5161,2440,1736,102,739,3834,1327
360007705560,36047043500,"Census Tract 435, Kings County, New York",5161,2440,1736,102,739,3834,1327
360009706274,36047043500,"Census Tract 435, Kings County, New York",5161,2440,1736,102,739,3834,1327
360009702799,36047043300,"Census Tract 433, Kings County, New York",4370,1953,1153,253,877,3489,881
360009705537,36047043300,"Census Tract 433, Kings County, New York",4370,1953,1153,253,877,3489,881
360009705725,36047043300,"Census Tract 433, Kings County, New York",4370,1953,1153,253,877,3489,881
360009702434,36047043300,"Census Tract 433, Kings County, New York",4370,1953,1153,253,877,3489,881
360015202734,36047044600,"Census Tract 446, Kings County, New York",1933,1185,13,614,91,201,1732
360015202377,36047045400,"Census Tract 454, Kings County, New York",1918,1576,22,122,169,192,1726
360009502348,36047080600,"Census Tract 806, Kings County, New York",3892,1688,2115,17,48,137,3755
360009505714,36047079400,"Census Tract 794, Kings County, New York",1820,6,1654,23,124,153,1667
360009505516,36047079400,"Census Tract 794, Kings County, New York",1820,6,1654,23,124,153,1667
360009505715,36047079400,"Census Tract 794, Kings County, New York",1820,6,1654,23,124,153,1667
360015705846,36047079400,"Census Tract 794, Kings County, New York",1820,6,1654,23,124,153,1667
360009500799,36047079400,"Census Tract 794, Kings County, New York",1820,6,1654,23,124,153,1667
360009502760,36047079400,"Census Tract 794, Kings County, New York",1820,6,1654,23,124,153,1667
360009505885,36047079400,"Census Tract 794, Kings County, New York",1820,6,1654,23,124,153,1667
360009505916,36047079400,"Census Tract 794, Kings County, New York",1820,6,1654,23,124,153,1667
360009504359,36047079400,"Census Tract 794, Kings County, New York",1820,6,1654,23,124,153,1667
360099906168,36047079400,"Census Tract 794, Kings County, New York",1820,6,1654,23,124,153,1667
360015302660,36047075400,"Census Tract 754, Kings County, New York",1488,1483,2,2,1,2,1486
360009501344,36047080200,"Census Tract 802, Kings County, New York",5115,385,4079,88,529,735,4380
360009505210,36047080200,"Census Tract 802, Kings County, New York",5115,385,4079,88,529,735,4380
360013504477,36047080200,"Census Tract 802, Kings County, New York",5115,385,4079,88,529,735,4380
360103806242,36047080200,"Census Tract 802, Kings County, New York",5115,385,4079,88,529,735,4380
360009104523,36047018100,"Census Tract 181, Kings County, New York",3530,2105,767,299,242,552,2978
360004604487,36047019300,"Census Tract 193, Kings County, New York",5967,2326,2595,410,214,860,5107
360009102784,36047019300,"Census Tract 193, Kings County, New York",5967,2326,2595,410,214,860,5107
360011902326,36047055100,"Census Tract 551, Kings County, New York",5507,3980,363,157,882,2871,2636
360101506206,36047048200,"Census Tract 482, Kings County, New York",5976,3399,372,1765,367,457,5519
360013502825,36047004100,"Census Tract 41, Kings County, New York",3587,2515,496,287,170,284,3303
360009502262,36047032900,"Census Tract 329, Kings County, New York",5494,1502,3388,0,489,476,5018
360009602790,36047099600,"Census Tract 996, Kings County, New York",3755,149,3504,81,14,71,3684
360015202753,36047042000,"Census Tract 420, Kings County, New York",1979,1723,9,124,107,108,1871
360015202370,36047040400,"Census Tract 404, Kings County, New York",2279,1248,0,900,131,266,2013
360009505870,36047036300,"Census Tract 363, Kings County, New York",3977,116,3402,0,396,601,3376
360009501347,36047036300,"Census Tract 363, Kings County, New York",3977,116,3402,0,396,601,3376
360015102391,36047016000,"Census Tract 160, Kings County, New York",4415,2769,211,776,395,1108,3307
360015106198,36047016000,"Census Tract 160, Kings County, New York",4415,2769,211,776,395,1108,3307
360009105698,36047002300,"Census Tract 23, Kings County, New York",4370,343,2588,689,518,1174,3196
360009102796,36047002300,"Census Tract 23, Kings County, New York",4370,343,2588,689,518,1174,3196
360009105930,36047002300,"Census Tract 23, Kings County, New York",4370,343,2588,689,518,1174,3196
360009602750,36047081400,"Census Tract 814, Kings County, New York",2688,8,2447,90,83,230,2458
360015102657,36047047600,"Census Tract 476, Kings County, New York",3929,3593,59,0,253,280,3649
360015304067,36047048000,"Census Tract 480, Kings County, New York",3416,2755,55,359,180,629,2787
360013504478,36047047000,"Census Tract 470, Kings County, New York",2763,2688,32,31,12,45,2718
360015102626,36047047000,"Census Tract 470, Kings County, New York",2763,2688,32,31,12,45,2718
360015303387,36047083000,"Census Tract 830, Kings County, New York",6484,134,5878,154,188,365,6119
360015101947,36047046800,"Census Tract 468, Kings County, New York",2151,2089,10,50,2,2,2149
360015202447,36047046400,"Census Tract 464, Kings County, New York",2826,2588,6,200,26,54,2772
360009105695,36047026500,"Census Tract 265, Kings County, New York",3764,440,2941,102,144,287,3477
360009102809,36047026500,"Census Tract 265, Kings County, New York",3764,440,2941,102,144,287,3477
360015302748,36047055800,"Census Tract 558, Kings County, New York",2256,1903,0,323,30,233,2023
360015302769,36047055800,"Census Tract 558, Kings County, New York",2256,1903,0,323,30,233,2023
360009102237,36047024100,"Census Tract 241, Kings County, New York",2480,1210,847,192,214,568,1912
360009702830,36047040900,"Census Tract 409, Kings County, New York",3944,1304,1190,46,1391,2906,1038
360009202226,36047013500,"Census Tract 135, Kings County, New York",3735,2675,389,227,200,460,3275
360009505709,36047081000,"Census Tract 810, Kings County, New York",2196,114,1860,77,74,99,2097
360009505510,36047081000,"Census Tract 810, Kings County, New York",2196,114,1860,77,74,99,2097
360009505515,36047081000,"Census Tract 810, Kings County, New York",2196,114,1860,77,74,99,2097
360009505710,36047081000,"Census Tract 810, Kings County, New York",2196,114,1860,77,74,99,2097
360009502832,36047081000,"Census Tract 810, Kings County, New York",2196,114,1860,77,74,99,2097
360009505818,36047032500,"Census Tract 325, Kings County, New York",6640,639,5781,60,49,419,6221
360009504495,36047032500,"Census Tract 325, Kings County, New York",6640,639,5781,60,49,419,6221
360009504882,36047032500,"Census Tract 325, Kings County, New York",6640,639,5781,60,49,419,6221
360015302669,36047054600,"Census Tract 546, Kings County, New York",4407,4034,81,223,59,258,4149
360015304070,36047054600,"Census Tract 546, Kings County, New York",4407,4034,81,223,59,258,4149
360103306240,36047031300,"Census Tract 313, Kings County, New York",4303,313,3730,50,165,253,4050
360015102679,36047028200,"Census Tract 282, Kings County, New York",3114,1596,14,1504,0,123,2991
360015102625,36047048800,"Census Tract 488, Kings County, New York",3945,2287,211,977,335,559,3386
360009202740,36047049800,"Census Tract 498, Kings County, New York",4580,1853,184,2092,224,308,4272
360015102266,36047049000,"Census Tract 490, Kings County, New York",5968,3641,439,852,555,1274,4694
360009202481,36047050000,"Census Tract 500, Kings County, New York",3508,2457,317,432,70,530,2978
360011905701,36047049700,"Census Tract 497, Kings County, New York",2914,2437,28,266,86,315,2599
360011902487,36047049700,"Census Tract 497, Kings County, New York",2914,2437,28,266,86,315,2599
360011505705,36047049900,"Census Tract 499, Kings County, New York",1793,1557,7,93,106,280,1513
360011902467,36047049900,"Census Tract 499, Kings County, New York",1793,1557,7,93,106,280,1513
360094806058,36047049900,"Census Tract 499, Kings County, New York",1793,1557,7,93,106,280,1513
360097206055,36047049900,"Census Tract 499, Kings County, New York",1793,1557,7,93,106,280,1513
360102906236,36047028300,"Census Tract 283, Kings County, New York",3654,660,2060,58,681,1567,2087
360015102689,36047018400,"Census Tract 184, Kings County, New York",2213,1243,39,923,0,59,2154
360009204889,36047015500,"Census Tract 155, Kings County, New York",3683,2963,273,191,29,131,3552
360009205529,36047015500,"Census Tract 155, Kings County, New York",3683,2963,273,191,29,131,3552
360009202818,36047015500,"Census Tract 155, Kings County, New York",3683,2963,273,191,29,131,3552
360009205531,36047015500,"Census Tract 155, Kings County, New York",3683,2963,273,191,29,131,3552
360009206292,36047015500,"Census Tract 155, Kings County, New York",3683,2963,273,191,29,131,3552
360009505514,36047021300,"Census Tract 213, Kings County, New York",4399,754,3488,75,36,147,4252
360009505523,36047021300,"Census Tract 213, Kings County, New York",4399,754,3488,75,36,147,4252
360009505712,36047021300,"Census Tract 213, Kings County, New York",4399,754,3488,75,36,147,4252
360009502756,36047021300,"Census Tract 213, Kings County, New York",4399,754,3488,75,36,147,4252
360009505713,36047021300,"Census Tract 213, Kings County, New York",4399,754,3488,75,36,147,4252
360009501937,36047021300,"Census Tract 213, Kings County, New York",4399,754,3488,75,36,147,4252
360014605815,36047014300,"Census Tract 143, Kings County, New York",3755,1846,125,326,1205,1901,1854
360009402108,36047038100,"Census Tract 381, Kings County, New York",5047,222,4356,0,401,637,4410
360009202041,36047008000,"Census Tract 80, Kings County, New York",4252,1505,171,320,1845,3261,991
360012002275,36047117601,"Census Tract 1176.01, Kings County, New York",3116,1700,790,76,533,2299,817
360009602782,36047086600,"Census Tract 866, Kings County, New York",3084,47,2932,0,85,151,2933
360015300800,36047051200,"Census Tract 512, Kings County, New York",6103,571,3860,36,1173,1679,4424
360011905896,36047050500,"Census Tract 505, Kings County, New York",4179,1789,779,532,844,2126,2053
360011905933,36047050500,"Census Tract 505, Kings County, New York",4179,1789,779,532,844,2126,2053
360011902764,36047050500,"Census Tract 505, Kings County, New York",4179,1789,779,532,844,2126,2053
360011906033,36047050500,"Census Tract 505, Kings County, New York",4179,1789,779,532,844,2126,2053
360009502763,36047050600,"Census Tract 506, Kings County, New York",5630,1405,2702,254,1193,2009,3621
360004104491,36047050700,"Census Tract 507, Kings County, New York",2452,1989,171,15,219,530,1922
360009402813,36047038500,"Census Tract 385, Kings County, New York",3404,499,2553,77,167,706,2698
360100006112,36047038500,"Census Tract 385, Kings County, New York",3404,499,2553,77,167,706,2698
360015102761,36047025800,"Census Tract 258, Kings County, New York",4445,2336,2,1662,420,699,3746
360009105508,36047024300,"Census Tract 243, Kings County, New York",4236,1043,2703,140,209,562,3674
360009202602,36047009200,"Census Tract 92, Kings County, New York",5249,1266,180,2194,1365,2194,3055
360009402758,36047030900,"Census Tract 309, Kings County, New York",2201,77,2018,8,14,170,2031
360016605902,36047040100,"Census Tract 401, Kings County, New York",3379,729,2003,25,546,1148,2231
360009702199,36047040100,"Census Tract 401, Kings County, New York",3379,729,2003,25,546,1148,2231
360015302009,36047064200,"Census Tract 642, Kings County, New York",2355,2122,7,122,49,205,2150
360009505819,36047021500,"Census Tract 215, Kings County, New York",5366,2419,2212,318,165,664,4702
360009502815,36047021500,"Census Tract 215, Kings County, New York",5366,2419,2212,318,165,664,4702
360015302717,36047052600,"Census Tract 526, Kings County, New York",4672,2126,1039,646,653,1041,3631
360011901913,36047051700,"Census Tract 517, Kings County, New York",1665,1318,122,185,31,217,1448
360011906080,36047051700,"Census Tract 517, Kings County, New York",1665,1318,122,185,31,217,1448
360011904358,36047053100,"Census Tract 531, Kings County, New York",8415,8211,27,51,83,615,7800
360014505814,36047053500,"Census Tract 535, Kings County, New York",4061,3819,0,0,242,297,3764
360011902091,36047053500,"Census Tract 535, Kings County, New York",4061,3819,0,0,242,297,3764
360011902291,36047052900,"Census Tract 529, Kings County, New York",4246,3872,61,0,313,395,3851
360011905699,36047051900,"Census Tract 519, Kings County, New York",4297,3350,129,271,361,592,3705
360011905703,36047051900,"Census Tract 519, Kings County, New York",4297,3350,129,271,361,592,3705
360011905704,36047051900,"Census Tract 519, Kings County, New York",4297,3350,129,271,361,592,3705
360011902095,36047051900,"Census Tract 519, Kings County, New York",4297,3350,129,271,361,592,3705
360011900892,36047052300,"Census Tract 523, Kings County, New York",5824,4006,161,301,1087,3386,2438
360011905884,36047052300,"Census Tract 523, Kings County, New York",5824,4006,161,301,1087,3386,2438
360011902221,36047052300,"Census Tract 523, Kings County, New York",5824,4006,161,301,1087,3386,2438
360011902865,36047052700,"Census Tract 527, Kings County, New York",6520,3704,823,247,1374,4804,1716
360011904604,36047052700,"Census Tract 527, Kings County, New York",6520,3704,823,247,1374,4804,1716
360009105697,36047020500,"Census Tract 205, Kings County, New York",2609,1548,714,162,3,135,2474
360009102069,36047020500,"Census Tract 205, Kings County, New York",2609,1548,714,162,3,135,2474
360009105811,36047026900,"Census Tract 269, Kings County, New York",2832,436,2321,9,31,415,2417
360012002720,36047111800,"Census Tract 1118, Kings County, New York",2735,286,2393,0,0,287,2448
360012006118,36047111800,"Census Tract 1118, Kings County, New York",2735,286,2393,0,0,287,2448
360105006293,36047111800,"Census Tract 1118, Kings County, New York",2735,286,2393,0,0,287,2448
360011902816,36047050900,"Census Tract 509, Kings County, New York",3821,3469,140,0,154,230,3591
360009502596,36047035300,"Census Tract 353, Kings County, New York",4686,903,3271,45,368,489,4197
360015302873,36047062600,"Census Tract 626, Kings County, New York",2620,1792,127,491,0,240,2380
360009101928,36047003300,"Census Tract 33, Kings County, New York",3008,1821,318,281,395,665,2343
360015102724,36047010800,"Census Tract 108, Kings County, New York",4661,658,35,3460,237,654,4007
360015102587,36047023200,"Census Tract 232, Kings County, New York",6142,5279,40,400,410,618,5524
360009005169,36005015900,"Census Tract 159, Bronx County, New York",1845,362,138,6,1272,1770,75
360016105893,36005015900,"Census Tract 159, Bronx County, New York",1845,362,138,6,1272,1770,75
360009006075,36005015900,"Census Tract 159, Bronx County, New York",1845,362,138,6,1272,1770,75
360008605790,36005014701,"Census Tract 147.01, Bronx County, New York",7209,820,3760,6,2573,3645,3564
360008605791,36005014701,"Census Tract 147.01, Bronx County, New York",7209,820,3760,6,2573,3645,3564
360008603747,36005014701,"Census Tract 147.01, Bronx County, New York",7209,820,3760,6,2573,3645,3564
360008605668,36005014701,"Census Tract 147.01, Bronx County, New York",7209,820,3760,6,2573,3645,3564
360008605794,36005014701,"Census Tract 147.01, Bronx County, New York",7209,820,3760,6,2573,3645,3564
360008703823,36005023703,"Census Tract 237.03, Bronx County, New York",4919,677,1015,87,2690,3724,1195
360008706142,36005023703,"Census Tract 237.03, Bronx County, New York",4919,677,1015,87,2690,3724,1195
360008706297,36005023703,"Census Tract 237.03, Bronx County, New York",4919,677,1015,87,2690,3724,1195
360011205672,36005022102,"Census Tract 221.02, Bronx County, New York",5006,1174,1030,43,2303,3959,1047
360009002209,36005007600,"Census Tract 76, Bronx County, New York",5853,1231,1349,433,2298,3861,1992
360008802364,36005033201,"Census Tract 332.01, Bronx County, New York",3861,1174,790,116,1329,2408,1453
360008705675,36005021700,"Census Tract 217, Bronx County, New York",5093,515,2235,0,2063,2800,2293
360008701307,36005021700,"Census Tract 217, Bronx County, New York",5093,515,2235,0,2063,2800,2293
360008405180,36005006300,"Census Tract 63, Bronx County, New York",4480,1292,1210,397,1422,2893,1587
360008602276,36005006300,"Census Tract 63, Bronx County, New York",4480,1292,1210,397,1422,2893,1587
360008400757,36005006300,"Census Tract 63, Bronx County, New York",4480,1292,1210,397,1422,2893,1587
360008401338,36005006300,"Census Tract 63, Bronx County, New York",4480,1292,1210,397,1422,2893,1587
360015202552,36047055600,"Census Tract 556, Kings County, New York",3885,3411,27,437,10,41,3844
360009205706,36047008200,"Census Tract 82, Kings County, New York",4304,1333,169,610,2021,3159,1145
360009205513,36047008200,"Census Tract 82, Kings County, New York",4304,1333,169,610,2021,3159,1145
360009402320,36047028900,"Census Tract 289, Kings County, New York",3344,869,2005,48,362,1139,2205
360009200821,36047004300,"Census Tract 43, Kings County, New York",3107,2104,170,271,426,575,2532
360009202778,36047004300,"Census Tract 43, Kings County, New York",3107,2104,170,271,426,575,2532
360009206279,36047004300,"Census Tract 43, Kings County, New York",3107,2104,170,271,426,575,2532
360012102623,36047030300,"Census Tract 303, Kings County, New York",5189,47,4604,47,446,672,4517
360011405700,36047038300,"Census Tract 383, Kings County, New York",4509,307,3874,37,212,625,3884
360011902096,36047050300,"Census Tract 503, Kings County, New York",2423,2180,0,78,146,597,1826
360015202619,36047042400,"Census Tract 424, Kings County, New York",3113,2082,39,803,151,345,2768
360011902773,36047049100,"Census Tract 491, Kings County, New York",5848,1556,1215,1727,1254,2298,3550
360011902156,36047057300,"Census Tract 573, Kings County, New York",2299,1937,195,90,42,133,2166
360015302662,36047057000,"Census Tract 570, Kings County, New York",3609,2453,127,904,125,214,3395
360009602701,36047084000,"Census Tract 840, Kings County, New York",2363,198,1902,20,182,227,2136
360015302673,36047083600,"Census Tract 836, Kings County, New York",1990,26,1855,45,8,19,1971
360015301788,36047083600,"Census Tract 836, Kings County, New York",1990,26,1855,45,8,19,1971
360015302695,36047059401,"Census Tract 594.01, Kings County, New York",7638,5382,73,2094,25,116,7522
360012105237,36047090000,"Census Tract 900, Kings County, New York",5671,258,4776,7,597,968,4703
360012102564,36047090000,"Census Tract 900, Kings County, New York",5671,258,4776,7,597,968,4703
360009505762,36047090000,"Census Tract 900, Kings County, New York",5671,258,4776,7,597,968,4703
360009602745,36047093000,"Census Tract 930, Kings County, New York",2493,8,2330,17,79,15,2478
360012102794,36047090600,"Census Tract 906, Kings County, New York",4394,335,3084,34,899,1429,2965
360012102805,36047090600,"Census Tract 906, Kings County, New York",4394,335,3084,34,899,1429,2965
360012102182,36047091800,"Census Tract 918, Kings County, New York",2994,267,2211,0,441,1312,1682
360012102636,36047091800,"Census Tract 918, Kings County, New York",2994,267,2211,0,441,1312,1682
360012102542,36047090800,"Census Tract 908, Kings County, New York",4936,215,3697,0,990,1298,3638
360012102822,36047090800,"Census Tract 908, Kings County, New York",4936,215,3697,0,990,1298,3638
360098406165,36047090800,"Census Tract 908, Kings County, New York",4936,215,3697,0,990,1298,3638
360099306157,36047090800,"Census Tract 908, Kings County, New York",4936,215,3697,0,990,1298,3638
360012106288,36047090800,"Census Tract 908, Kings County, New York",4936,215,3697,0,990,1298,3638
360009605957,36047093600,"Census Tract 936, Kings County, New York",1931,0,1844,67,0,21,1910
360009605964,36047093600,"Census Tract 936, Kings County, New York",1931,0,1844,67,0,21,1910
360009602795,36047093600,"Census Tract 936, Kings County, New York",1931,0,1844,67,0,21,1910
360009606042,36047093600,"Census Tract 936, Kings County, New York",1931,0,1844,67,0,21,1910
360013504561,36047092200,"Census Tract 922, Kings County, New York",2927,177,2712,0,0,203,2724
360012105723,36047092200,"Census Tract 922, Kings County, New York",2927,177,2712,0,0,203,2724
360012105997,36047092200,"Census Tract 922, Kings County, New York",2927,177,2712,0,0,203,2724
360012106064,36047092200,"Census Tract 922, Kings County, New York",2927,177,2712,0,0,203,2724
360015302768,36047059200,"Census Tract 592, Kings County, New York",4379,2740,97,1518,0,83,4296
360012002570,36047115000,"Census Tract 1150, Kings County, New York",2804,375,1525,106,515,1121,1683
360009605959,36047088000,"Census Tract 880, Kings County, New York",3202,115,3029,0,30,220,2982
360009605960,36047088000,"Census Tract 880, Kings County, New York",3202,115,3029,0,30,220,2982
360009605965,36047088000,"Census Tract 880, Kings County, New York",3202,115,3029,0,30,220,2982
360012002776,36047098200,"Census Tract 982, Kings County, New York",4040,220,3215,0,547,912,3128
360012006280,36047098200,"Census Tract 982, Kings County, New York",4040,220,3215,0,547,912,3128
360011902412,36047059100,"Census Tract 591, Kings County, New York",3825,3442,31,62,165,561,3264
360009102064,36047000100,"Census Tract 1, Kings County, New York",4367,3149,410,260,364,585,3782
360009202175,36047015300,"Census Tract 153, Kings County, New York",2909,2386,140,228,97,294,2615
360009202461,36047014100,"Census Tract 141, Kings County, New York",3980,2429,298,552,514,921,3059
360009202325,36047014700,"Census Tract 147, Kings County, New York",2244,1379,84,53,528,955,1289
360009205501,36047014700,"Census Tract 147, Kings County, New York",2244,1379,84,53,528,955,1289
360009204474,36047014700,"Census Tract 147, Kings County, New York",2244,1379,84,53,528,955,1289
360009504813,36047016300,"Census Tract 163, Kings County, New York",3060,1854,705,297,87,215,2845
360009202072,36047014900,"Census Tract 149, Kings County, New York",5723,4577,274,419,272,1051,4672
360009202557,36047017100,"Census Tract 171, Kings County, New York",3967,3443,68,320,42,269,3698
360009202403,36047016700,"Census Tract 167, Kings County, New York",4946,4070,108,249,375,630,4316
360009602496,36047087000,"Census Tract 870, Kings County, New York",3124,38,2915,0,171,282,2842
360014705821,36047087600,"Census Tract 876, Kings County, New York",1630,397,1120,21,15,126,1504
360009505711,36047087600,"Census Tract 876, Kings County, New York",1630,397,1120,21,15,126,1504
360009502631,36047085600,"Census Tract 856, Kings County, New York",3521,16,3375,20,36,354,3167
360009502833,36047088200,"Census Tract 882, Kings County, New York",6587,99,6280,109,48,231,6356
360009506176,36047088200,"Census Tract 882, Kings County, New York",6587,99,6280,109,48,231,6356
360015300871,36047061600,"Census Tract 616, Kings County, New York",1757,1696,42,9,10,42,1715
360015302230,36047060000,"Census Tract 600, Kings County, New York",5510,4979,98,430,3,467,5043
360015203011,36047060800,"Census Tract 608, Kings County, New York",3031,2624,159,195,21,150,2881
360009605961,36047095000,"Census Tract 950, Kings County, New York",3070,94,2936,0,34,93,2977
360009605967,36047095000,"Census Tract 950, Kings County, New York",3070,94,2936,0,34,93,2977
360009605956,36047095000,"Census Tract 950, Kings County, New York",3070,94,2936,0,34,93,2977
360009605966,36047095000,"Census Tract 950, Kings County, New York",3070,94,2936,0,34,93,2977
360009606054,36047095000,"Census Tract 950, Kings County, New York",3070,94,2936,0,34,93,2977
360009602283,36047095600,"Census Tract 956, Kings County, New York",4682,309,3969,211,151,384,4298
360008802394,36005022404,"Census Tract 224.04, Bronx County, New York",3951,1743,1010,234,874,1373,2578
360008702313,36005023704,"Census Tract 237.04, Bronx County, New York",3702,422,1144,20,2021,2704,998
360008706015,36005023704,"Census Tract 237.04, Bronx County, New York",3702,422,1144,20,2021,2704,998
360008706057,36005023704,"Census Tract 237.04, Bronx County, New York",3702,422,1144,20,2021,2704,998
360008706141,36005023704,"Census Tract 237.04, Bronx County, New York",3702,422,1144,20,2021,2704,998
360009005166,36005015300,"Census Tract 153, Bronx County, New York",4471,568,2013,35,1484,2537,1934
360009002260,36005015300,"Census Tract 153, Bronx County, New York",4471,568,2013,35,1484,2537,1934
360009002491,36005015300,"Census Tract 153, Bronx County, New York",4471,568,2013,35,1484,2537,1934
360009006002,36005015300,"Census Tract 153, Bronx County, New York",4471,568,2013,35,1484,2537,1934
360008705140,36005025100,"Census Tract 251, Bronx County, New York",6246,930,1579,430,2812,4214,2032
360009205498,36047003900,"Census Tract 39, Kings County, New York",2498,1439,390,376,157,415,2083
360009202173,36047003900,"Census Tract 39, Kings County, New York",2498,1439,390,376,157,415,2083
360009204497,36047003900,"Census Tract 39, Kings County, New York",2498,1439,390,376,157,415,2083
360009200826,36047003900,"Census Tract 39, Kings County, New York",2498,1439,390,376,157,415,2083
360009105928,36047001100,"Census Tract 11, Kings County, New York",701,451,74,89,38,69,632
360015905898,36047002901,"Census Tract 29.01, Kings County, New York",3409,292,1769,432,782,1188,2221
360009102280,36047002901,"Census Tract 29.01, Kings County, New York",3409,292,1769,432,782,1188,2221
360009101955,36047001300,"Census Tract 13, Kings County, New York",2627,1646,295,352,304,432,2195
360009102453,36047001300,"Census Tract 13, Kings County, New York",2627,1646,295,352,304,432,2195
360009106164,36047001300,"Census Tract 13, Kings County, New York",2627,1646,295,352,304,432,2195
360009102811,36047002100,"Census Tract 21, Kings County, New York",3798,3006,222,261,114,258,3540
360009105696,36047002100,"Census Tract 21, Kings County, New York",3798,3006,222,261,114,258,3540
360008805800,36005039000,"Census Tract 390, Bronx County, New York",3265,278,2457,16,335,611,2654
360008805969,36005039000,"Census Tract 390, Bronx County, New York",3265,278,2457,16,335,611,2654
360008805801,36005039000,"Census Tract 390, Bronx County, New York",3265,278,2457,16,335,611,2654
360008805802,36005039000,"Census Tract 390, Bronx County, New York",3265,278,2457,16,335,611,2654
360009001315,36005005600,"Census Tract 56, Bronx County, New York",2391,376,610,45,1202,1660,731
360009003847,36005005600,"Census Tract 56, Bronx County, New York",2391,376,610,45,1202,1660,731
360009001341,36005005600,"Census Tract 56, Bronx County, New York",2391,376,610,45,1202,1660,731
360009001339,36005005600,"Census Tract 56, Bronx County, New York",2391,376,610,45,1202,1660,731
360009001767,36005005600,"Census Tract 56, Bronx County, New York",2391,376,610,45,1202,1660,731
360009006030,36005005600,"Census Tract 56, Bronx County, New York",2391,376,610,45,1202,1660,731
360009006160,36005005600,"Census Tract 56, Bronx County, New York",2391,376,610,45,1202,1660,731
360099506103,36005005600,"Census Tract 56, Bronx County, New York",2391,376,610,45,1202,1660,731
360009006276,36005005600,"Census Tract 56, Bronx County, New York",2391,376,610,45,1202,1660,731
360008802336,36005042800,"Census Tract 428, Bronx County, New York",2043,127,1572,59,152,223,1820
360008805880,36005033000,"Census Tract 330, Bronx County, New York",5744,2251,1122,109,2200,3105,2639
360008805953,36005033000,"Census Tract 330, Bronx County, New York",5744,2251,1122,109,2200,3105,2639
360008806129,36005033000,"Census Tract 330, Bronx County, New York",5744,2251,1122,109,2200,3105,2639
360008502441,36005004001,"Census Tract 40.01, Bronx County, New York",1550,378,330,370,249,457,1093
360008502463,36005004001,"Census Tract 40.01, Bronx County, New York",1550,378,330,370,249,457,1093
360008602486,36005014500,"Census Tract 145, Bronx County, New York",6757,558,2977,10,2887,3688,3069
360004804457,36005014500,"Census Tract 145, Bronx County, New York",6757,558,2977,10,2887,3688,3069
360008605192,36005023301,"Census Tract 233.01, Bronx County, New York",4378,403,1365,0,2412,3153,1225
360095606025,36005019500,"Census Tract 195, Bronx County, New York",7593,1056,2606,100,3748,5235,2358
360008402138,36005006900,"Census Tract 69, Bronx County, New York",7769,787,3522,120,2995,4545,3224
360008705993,36005028100,"Census Tract 281, Bronx County, New York",3940,2083,832,50,763,1361,2579
360008702361,36005028100,"Census Tract 281, Bronx County, New York",3940,2083,832,50,763,1361,2579
360009000227,36005006000,"Census Tract 60, Bronx County, New York",1192,144,225,7,816,986,206
360009102074,36047019900,"Census Tract 199, Kings County, New York",2875,1336,1000,242,80,277,2598
360009105901,36047018300,"Census Tract 183, Kings County, New York",2710,1549,527,260,243,348,2362
360009102106,36047018300,"Census Tract 183, Kings County, New York",2710,1549,527,260,243,348,2362
360009102205,36047018700,"Census Tract 187, Kings County, New York",1584,644,407,99,265,422,1162
360009106205,36047018700,"Census Tract 187, Kings County, New York",1584,644,407,99,265,422,1162
360015102618,36047019600,"Census Tract 196, Kings County, New York",5361,2123,152,2320,766,1211,4150
360015102585,36047018000,"Census Tract 180, Kings County, New York",3253,1984,0,884,376,728,2525
360015106197,36047018000,"Census Tract 180, Kings County, New York",3253,1984,0,884,376,728,2525
360013504319,36047017900,"Census Tract 179, Kings County, New York",4262,1012,2599,186,316,864,3398
360015102036,36047018200,"Census Tract 182, Kings County, New York",3218,1328,39,1663,179,607,2611
360015102471,36047020600,"Census Tract 206, Kings County, New York",2611,1693,19,878,21,192,2419
360015102775,36047020600,"Census Tract 206, Kings County, New York",2611,1693,19,878,21,192,2419
360015102421,36047019000,"Census Tract 190, Kings County, New York",5310,2307,53,2075,657,1589,3721
360009102315,36047019100,"Census Tract 191, Kings County, New York",2861,1208,762,48,625,821,2040
360008805810,36005040400,"Census Tract 404, Bronx County, New York",2872,45,2419,0,299,412,2460
360008602288,36005022902,"Census Tract 229.02, Bronx County, New York",3262,508,1073,9,1612,2333,929
360008802389,36005042000,"Census Tract 420, Bronx County, New York",3397,368,2018,97,804,1153,2244
360008505653,36005007400,"Census Tract 74, Bronx County, New York",3724,970,1100,7,1575,2612,1112
360008502505,36005007400,"Census Tract 74, Bronx County, New York",3724,970,1100,7,1575,2612,1112
360008502011,36005013300,"Census Tract 133, Bronx County, New York",7067,399,2779,51,3751,4457,2610
360008505987,36005015800,"Census Tract 158, Bronx County, New York",1233,744,129,36,209,498,735
360008502295,36005015800,"Census Tract 158, Bronx County, New York",1233,744,129,36,209,498,735
360008505982,36005015800,"Census Tract 158, Bronx County, New York",1233,744,129,36,209,498,735
360008506162,36005015800,"Census Tract 158, Bronx County, New York",1233,744,129,36,209,498,735
360008806144,36005046000,"Census Tract 460, Bronx County, New York",2608,115,2074,11,340,572,2036
360008502264,36005008300,"Census Tract 83, Bronx County, New York",5974,619,1764,6,3315,4893,1081
360008505122,36005008300,"Census Tract 83, Bronx County, New York",5974,619,1764,6,3315,4893,1081
360098606161,36005008300,"Census Tract 83, Bronx County, New York",5974,619,1764,6,3315,4893,1081
360008802404,36005028800,"Census Tract 288, Bronx County, New York",3496,2677,81,459,279,392,3104
360008702357,36005043100,"Census Tract 431, Bronx County, New York",10419,1654,2677,1193,4343,5683,4736
360008705569,36005043100,"Census Tract 431, Bronx County, New York",10419,1654,2677,1193,4343,5683,4736
360008805179,36005022800,"Census Tract 228, Bronx County, New York",6156,1539,1307,1010,2147,2877,3279
360008805803,36005022800,"Census Tract 228, Bronx County, New York",6156,1539,1307,1010,2147,2877,3279
360009005689,36005013100,"Census Tract 131, Bronx County, New York",4906,477,1471,48,2784,3377,1529
360009005808,36005013100,"Census Tract 131, Bronx County, New York",4906,477,1471,48,2784,3377,1529
360009005809,36005013100,"Census Tract 131, Bronx County, New York",4906,477,1471,48,2784,3377,1529
360009005658,36005013100,"Census Tract 131, Bronx County, New York",4906,477,1471,48,2784,3377,1529
360102706234,36005013100,"Census Tract 131, Bronx County, New York",4906,477,1471,48,2784,3377,1529
360009006163,36005013100,"Census Tract 131, Bronx County, New York",4906,477,1471,48,2784,3377,1529
360009002477,36005037100,"Census Tract 371, Bronx County, New York",3767,942,1948,1,790,1878,1889
360009005805,36005037100,"Census Tract 371, Bronx County, New York",3767,942,1948,1,790,1878,1889
360009005691,36005037100,"Census Tract 371, Bronx County, New York",3767,942,1948,1,790,1878,1889
360009002350,36005037100,"Census Tract 371, Bronx County, New York",3767,942,1948,1,790,1878,1889
360009005807,36005037100,"Census Tract 371, Bronx County, New York",3767,942,1948,1,790,1878,1889
360009002388,36005021601,"Census Tract 216.01, Bronx County, New York",3970,935,905,159,1911,2632,1338
360009006261,36005021601,"Census Tract 216.01, Bronx County, New York",3970,935,905,159,1911,2632,1338
360009006266,36005021601,"Census Tract 216.01, Bronx County, New York",3970,935,905,159,1911,2632,1338
360008402269,36005003300,"Census Tract 33, Bronx County, New York",3852,1021,1541,0,1252,2702,1150
360015102396,36047021400,"Census Tract 214, Kings County, New York",2599,1258,0,1322,7,185,2414
360009902622,36081127700,"Census Tract 1277, Queens County, New York",3409,2441,221,630,105,140,3269
360010002213,36081025400,"Census Tract 254, Queens County, New York",12663,98,6528,651,1363,5179,7484
360105306289,36081008500,"Census Tract 85, Queens County, New York",1173,551,21,164,362,512,661
360012302512,36081099802,"Census Tract 998.02, Queens County, New York",5258,2014,2924,91,101,1155,4103
360012301912,36081029400,"Census Tract 294, Queens County, New York",7478,138,6568,25,650,959,6519
360010202470,36081035700,"Census Tract 357, Queens County, New York",3930,903,1203,367,1248,1764,2166
360010002384,36081072300,"Census Tract 723, Queens County, New York",1831,1193,81,496,47,144,1687
360009602786,36047103400,"Census Tract 1034, Kings County, New York",3697,633,2305,0,410,843,2854
360012002787,36047107800,"Census Tract 1078, Kings County, New York",3704,144,3389,13,88,342,3362
360013504605,36047112600,"Census Tract 1126, Kings County, New York",3936,526,2983,19,408,1056,2880
360014905824,36047112600,"Census Tract 1126, Kings County, New York",3936,526,2983,19,408,1056,2880
360012002080,36047112600,"Census Tract 1126, Kings County, New York",3936,526,2983,19,408,1056,2880
360012003002,36047112800,"Census Tract 1128, Kings County, New York",3898,322,3068,84,392,701,3197
360012002651,36047112800,"Census Tract 1128, Kings County, New York",3898,322,3068,84,392,701,3197
360012002611,36047113000,"Census Tract 1130, Kings County, New York",4347,280,3542,0,284,956,3391
360012005718,36047115600,"Census Tract 1156, Kings County, New York",4397,379,2935,70,888,1650,2747
360012005719,36047115600,"Census Tract 1156, Kings County, New York",4397,379,2935,70,888,1650,2747
360012005716,36047115600,"Census Tract 1156, Kings County, New York",4397,379,2935,70,888,1650,2747
360012005717,36047115600,"Census Tract 1156, Kings County, New York",4397,379,2935,70,888,1650,2747
360012002406,36047117202,"Census Tract 1172.02, Kings County, New York",3107,1580,1106,99,311,1906,1201
360012003000,36047117000,"Census Tract 1170, Kings County, New York",1817,453,747,44,508,929,888
360012001998,36047117000,"Census Tract 1170, Kings County, New York",1817,453,747,44,508,929,888
360102806237,36047117000,"Census Tract 1170, Kings County, New York",1817,453,747,44,508,929,888
360012002296,36047116400,"Census Tract 1164, Kings County, New York",2929,367,2279,55,153,791,2138
360012006100,36047116400,"Census Tract 1164, Kings County, New York",2929,367,2279,55,153,791,2138
360012006153,36047116400,"Census Tract 1164, Kings County, New York",2929,367,2279,55,153,791,2138
360012004351,36047118201,"Census Tract 1182.01, Kings County, New York",3081,1108,1027,90,797,1998,1083
360012002604,36047118400,"Census Tract 1184, Kings County, New York",5079,2197,1380,692,635,2825,2254
360012002824,36047119200,"Census Tract 1192, Kings County, New York",3073,1025,1576,198,227,1420,1653
360012002572,36047120000,"Census Tract 1200, Kings County, New York",2057,680,950,194,199,781,1276
360012002712,36047120200,"Census Tract 1202, Kings County, New York",2104,578,844,359,297,666,1438
360012001941,36047119600,"Census Tract 1196, Kings County, New York",4872,937,3018,687,135,1162,3710
360098906097,36047120800,"Census Tract 1208, Kings County, New York",8706,882,7194,115,286,1394,7312
360012001954,36047118000,"Census Tract 1180, Kings County, New York",0,0,0,0,0,0,0
360012005931,36047118000,"Census Tract 1180, Kings County, New York",0,0,0,0,0,0,0
360012006031,36047118000,"Census Tract 1180, Kings County, New York",0,0,0,0,0,0,0
360012006045,36047118000,"Census Tract 1180, Kings County, New York",0,0,0,0,0,0,0
360012006046,36047118000,"Census Tract 1180, Kings County, New York",0,0,0,0,0,0,0
360010205287,36081018101,"Census Tract 181.01, Queens County, New York",4413,2745,0,1409,193,1783,2630
360010201821,36081003300,"Census Tract 33, Queens County, New York",2675,1333,103,1010,164,856,1819
360010202420,36081003300,"Census Tract 33, Queens County, New York",2675,1333,103,1010,164,856,1819
360010202562,36081003300,"Census Tract 33, Queens County, New York",2675,1333,103,1010,164,856,1819
360009801791,36081019900,"Census Tract 199, Queens County, New York",1257,320,290,200,331,637,620
360009504883,36047034700,"Census Tract 347, Kings County, New York",3157,72,2810,0,265,478,2679
360015102738,36047017000,"Census Tract 170, Kings County, New York",3758,1977,0,1548,233,492,3266
360101606201,36047020100,"Census Tract 201, Kings County, New York",3814,1652,1697,194,75,401,3413
360009402163,36047027300,"Census Tract 273, Kings County, New York",2582,168,2260,33,67,127,2455
360009406050,36047027300,"Census Tract 273, Kings County, New York",2582,168,2260,33,67,127,2455
360015103006,36047013000,"Census Tract 130, Kings County, New York",4971,3066,116,1059,582,1113,3858
360015202736,36047041000,"Census Tract 410, Kings County, New York",1794,1388,13,329,64,247,1547
360015205942,36047032600,"Census Tract 326, Kings County, New York",7140,1923,2603,1347,832,2201,4939
360100406101,36047032600,"Census Tract 326, Kings County, New York",7140,1923,2603,1347,832,2201,4939
360009102356,36047024700,"Census Tract 247, Kings County, New York",1999,394,1406,94,53,163,1836
360012002730,36047122000,"Census Tract 1220, Kings County, New York",5407,432,4345,56,500,1152,4255
360012002820,36047113400,"Census Tract 1134, Kings County, New York",3000,303,1981,0,606,1175,1825
360103006230,36047113400,"Census Tract 1134, Kings County, New York",3000,303,1981,0,606,1175,1825
360012002538,36047115800,"Census Tract 1158, Kings County, New York",2849,473,2094,0,186,885,1964
360015302727,36047064600,"Census Tract 646, Kings County, New York",2507,2170,208,89,15,427,2080
360012302714,36081099801,"Census Tract 998.01, Queens County, New York",7110,1576,4811,348,240,1531,5579
360012205979,36081099704,"Census Tract 997.04, Queens County, New York",6936,4840,137,1638,294,675,6261
360012202600,36081099704,"Census Tract 997.04, Queens County, New York",6936,4840,137,1638,294,675,6261
360012305730,36081100802,"Census Tract 1008.02, Queens County, New York",8615,2761,4104,159,931,2418,6197
360012305890,36081100802,"Census Tract 1008.02, Queens County, New York",8615,2761,4104,159,931,2418,6197
360012301948,36081100802,"Census Tract 1008.02, Queens County, New York",8615,2761,4104,159,931,2418,6197
360012305999,36081100802,"Census Tract 1008.02, Queens County, New York",8615,2761,4104,159,931,2418,6197
360012306079,36081100802,"Census Tract 1008.02, Queens County, New York",8615,2761,4104,159,931,2418,6197
360012206032,36081079701,"Census Tract 797.01, Queens County, New York",6649,566,262,5306,460,649,6000
360009802263,36081044302,"Census Tract 443.02, Queens County, New York",4787,1373,655,1810,829,2041,2746
360010002667,36081075702,"Census Tract 757.02, Queens County, New York",4408,2666,295,1255,61,481,3927
360009902693,36081129103,"Census Tract 1291.03, Queens County, New York",3646,2439,105,980,88,206,3440
360009902646,36081129104,"Census Tract 1291.04, Queens County, New York",4017,2108,263,1371,37,238,3779
360010002653,36081071305,"Census Tract 713.05, Queens County, New York",5026,2703,69,1353,700,968,4058
360010002696,36081071702,"Census Tract 717.02, Queens County, New York",3330,1961,62,1015,170,651,2679
360012302395,36081097203,"Census Tract 972.03, Queens County, New York",7072,1470,4344,291,949,2591,4481
360008102577,36061021303,"Census Tract 213.03, New York County, New York",5686,929,2752,55,1622,1987,3699
360008106116,36061021303,"Census Tract 213.03, New York County, New York",5686,929,2752,55,1622,1987,3699
360007706158,36061031704,"Census Tract 317.04, New York County, New York",6375,4413,82,1408,78,899,5476
360007704406,36061023802,"Census Tract 238.02, New York County, New York",2383,1572,475,295,23,316,2067
360008602338,36005017902,"Census Tract 179.02, Bronx County, New York",3618,395,1417,0,1759,2094,1524
360008702204,36005040501,"Census Tract 405.01, Bronx County, New York",3916,379,1009,212,2194,2646,1270
360008602344,36005018102,"Census Tract 181.02, Bronx County, New York",5862,784,2258,231,2504,3178,2684
360008606132,36005018102,"Census Tract 181.02, Bronx County, New York",5862,784,2258,231,2504,3178,2684
360008606150,36005018102,"Census Tract 181.02, Bronx County, New York",5862,784,2258,231,2504,3178,2684
360008605670,36005018302,"Census Tract 183.02, Bronx County, New York",3934,566,1075,92,1910,2719,1215
360008602961,36005018302,"Census Tract 183.02, Bronx County, New York",3934,566,1075,92,1910,2719,1215
360008601986,36005018302,"Census Tract 183.02, Bronx County, New York",3934,566,1075,92,1910,2719,1215
360008602160,36005018302,"Census Tract 183.02, Bronx County, New York",3934,566,1075,92,1910,2719,1215
360008605865,36005018302,"Census Tract 183.02, Bronx County, New York",3934,566,1075,92,1910,2719,1215
360008606113,36005018302,"Census Tract 183.02, Bronx County, New York",3934,566,1075,92,1910,2719,1215
360008606121,36005018302,"Census Tract 183.02, Bronx County, New York",3934,566,1075,92,1910,2719,1215
360008700739,36005038301,"Census Tract 383.01, Bronx County, New York",4372,513,1222,15,2335,3265,1107
360008702067,36005038301,"Census Tract 383.01, Bronx County, New York",4372,513,1222,15,2335,3265,1107
360008605663,36005014702,"Census Tract 147.02, Bronx County, New York",5089,322,2724,0,1875,2437,2652
360008602238,36005014702,"Census Tract 147.02, Bronx County, New York",5089,322,2724,0,1875,2437,2652
360008602410,36005020502,"Census Tract 205.02, Bronx County, New York",2077,321,846,0,842,1074,1003
360009000744,36005012901,"Census Tract 129.01, Bronx County, New York",3828,355,1763,178,1508,2181,1647
360011105662,36005012901,"Census Tract 129.01, Bronx County, New York",3828,355,1763,178,1508,2181,1647
360009006218,36005012901,"Census Tract 129.01, Bronx County, New York",3828,355,1763,178,1508,2181,1647
360008505123,36005015200,"Census Tract 152, Bronx County, New York",2960,1251,447,160,943,1628,1332
360008503740,36005015200,"Census Tract 152, Bronx County, New York",2960,1251,447,160,943,1628,1332
360013504560,36005015200,"Census Tract 152, Bronx County, New York",2960,1251,447,160,943,1628,1332
360008502509,36005018500,"Census Tract 185, Bronx County, New York",6904,481,3170,0,3030,3624,3280
360008505121,36005018500,"Census Tract 185, Bronx County, New York",6904,481,3170,0,3030,3624,3280
360008502530,36005018500,"Census Tract 185, Bronx County, New York",6904,481,3170,0,3030,3624,3280
360095506027,36005018500,"Census Tract 185, Bronx County, New York",6904,481,3170,0,3030,3624,3280
360101206219,36005018500,"Census Tract 185, Bronx County, New York",6904,481,3170,0,3030,3624,3280
360008406056,36005018500,"Census Tract 185, Bronx County, New York",6904,481,3170,0,3030,3624,3280
360008701304,36005029302,"Census Tract 293.02, Bronx County, New York",5471,4079,407,195,658,1167,4304
360008705550,36005026701,"Census Tract 267.01, Bronx County, New York",3439,546,323,621,1702,2420,1019
360008703820,36005024502,"Census Tract 245.02, Bronx County, New York",3669,383,1291,0,1934,2450,1219
360008703811,36005024502,"Census Tract 245.02, Bronx County, New York",3669,383,1291,0,1934,2450,1219
360008703783,36005040502,"Census Tract 405.02, Bronx County, New York",5594,584,1848,121,2889,3784,1810
360008705139,36005038302,"Census Tract 383.02, Bronx County, New York",5350,328,2877,0,1911,2747,2603
360096806074,36005038302,"Census Tract 383.02, Bronx County, New York",5350,328,2877,0,1911,2747,2603
360008802450,36005034800,"Census Tract 348, Bronx County, New York",7357,700,4329,83,1746,2910,4447
360008705138,36005039500,"Census Tract 395, Bronx County, New York",3893,440,1702,0,1681,2629,1264
360008700130,36005039500,"Census Tract 395, Bronx County, New York",3893,440,1702,0,1681,2629,1264
360008602250,36005039500,"Census Tract 395, Bronx County, New York",3893,440,1702,0,1681,2629,1264
360008602751,36005039500,"Census Tract 395, Bronx County, New York",3893,440,1702,0,1681,2629,1264
360008702318,36005033700,"Census Tract 337, Bronx County, New York",2353,1810,187,117,146,293,2060
360013502079,36005020000,"Census Tract 200, Bronx County, New York",4672,1052,315,1161,1668,2602,2070
360008702513,36005030900,"Census Tract 309, Bronx County, New York",3945,3347,330,119,113,434,3511
360008702121,36005030900,"Census Tract 309, Bronx County, New York",3945,3347,330,119,113,434,3511
360008705137,36005037504,"Census Tract 375.04, Bronx County, New York",4041,1076,1340,77,1428,2493,1548
360008705760,36005037504,"Census Tract 375.04, Bronx County, New York",4041,1076,1340,77,1428,2493,1548
360008702440,36005037504,"Census Tract 375.04, Bronx County, New York",4041,1076,1340,77,1428,2493,1548
360011305688,36005022200,"Census Tract 222, Bronx County, New York",2965,664,631,360,1195,1883,1082
360008802397,36005022200,"Census Tract 222, Bronx County, New York",2965,664,631,360,1195,1883,1082
360008802469,36005022200,"Census Tract 222, Bronx County, New York",2965,664,631,360,1195,1883,1082
360008501979,36005004200,"Census Tract 42, Bronx County, New York",7599,1611,4228,85,1446,3643,3956
360008502380,36005004200,"Census Tract 42, Bronx County, New York",7599,1611,4228,85,1446,3643,3956
360008506156,36005004200,"Census Tract 42, Bronx County, New York",7599,1611,4228,85,1446,3643,3956
360016505889,36005011700,"Census Tract 117, Bronx County, New York",1512,406,514,19,527,1063,449
360013505853,36005011700,"Census Tract 117, Bronx County, New York",1512,406,514,19,527,1063,449
360008506081,36005011700,"Census Tract 117, Bronx County, New York",1512,406,514,19,527,1063,449
360008805558,36005009600,"Census Tract 96, Bronx County, New York",2557,381,477,451,1145,1496,1061
360008402098,36005005100,"Census Tract 51, Bronx County, New York",5814,757,2224,9,2654,3961,1853
360008405119,36005005100,"Census Tract 51, Bronx County, New York",5814,757,2224,9,2654,3961,1853
360008405520,36005005100,"Census Tract 51, Bronx County, New York",5814,757,2224,9,2654,3961,1853
360008405504,36005005100,"Census Tract 51, Bronx County, New York",5814,757,2224,9,2654,3961,1853
360008502211,36005009300,"Census Tract 93, Bronx County, New York",6265,1491,1791,0,2737,4488,1777
360008604355,36005005300,"Census Tract 53, Bronx County, New York",3305,150,1825,0,959,1421,1884
360008602737,36005005300,"Census Tract 53, Bronx County, New York",3305,150,1825,0,959,1421,1884
360010302057,36085025100,"Census Tract 251, Richmond County, New York",5796,5460,0,285,51,290,5506
360010305548,36085027702,"Census Tract 277.02, Richmond County, New York",6097,4917,195,748,174,1060,5037
360010305835,36085027702,"Census Tract 277.02, Richmond County, New York",6097,4917,195,748,174,1060,5037
360010306006,36085027702,"Census Tract 277.02, Richmond County, New York",6097,4917,195,748,174,1060,5037
360010306024,36085027702,"Census Tract 277.02, Richmond County, New York",6097,4917,195,748,174,1060,5037
360010306149,36085030301,"Census Tract 303.01, Richmond County, New York",5061,3320,561,656,371,1391,3670
360099606147,36085030301,"Census Tract 303.01, Richmond County, New York",5061,3320,561,656,371,1391,3670
360010302127,36085029102,"Census Tract 291.02, Richmond County, New York",2712,2173,137,134,161,467,2245
360010302102,36085014100,"Census Tract 141, Richmond County, New York",2725,1855,393,153,287,1247,1478
360010302286,36085027705,"Census Tract 277.05, Richmond County, New York",5788,4199,107,1424,58,497,5291
360007604868,36061002601,"Census Tract 26.01, New York County, New York",4052,1676,372,640,1157,1934,2118
360013605765,36061002601,"Census Tract 26.01, New York County, New York",4052,1676,372,640,1157,1934,2118
360007602087,36061002601,"Census Tract 26.01, New York County, New York",4052,1676,372,640,1157,1934,2118
360007605619,36061002601,"Census Tract 26.01, New York County, New York",4052,1676,372,640,1157,1934,2118
360007605620,36061002601,"Census Tract 26.01, New York County, New York",4052,1676,372,640,1157,1934,2118
360007605763,36061004000,"Census Tract 40, New York County, New York",9543,7583,603,1084,21,640,8903
360007602101,36061004000,"Census Tract 40, New York County, New York",9543,7583,603,1084,21,640,8903
360007604873,36061002201,"Census Tract 22.01, New York County, New York",6874,2024,1059,1700,1678,3029,3845
360007602511,36061002201,"Census Tract 22.01, New York County, New York",6874,2024,1059,1700,1678,3029,3845
360007705499,36061001800,"Census Tract 18, New York County, New York",8232,2497,296,4719,452,794,7438
360007705532,36061001800,"Census Tract 18, New York County, New York",8232,2497,296,4719,452,794,7438
360007705623,36061001800,"Census Tract 18, New York County, New York",8232,2497,296,4719,452,794,7438
360007705770,36061001800,"Census Tract 18, New York County, New York",8232,2497,296,4719,452,794,7438
360007705771,36061001800,"Census Tract 18, New York County, New York",8232,2497,296,4719,452,794,7438
360007704402,36061001600,"Census Tract 16, New York County, New York",7675,1121,54,6167,100,337,7338
360007705625,36061001600,"Census Tract 16, New York County, New York",7675,1121,54,6167,100,337,7338
360007702187,36061001600,"Census Tract 16, New York County, New York",7675,1121,54,6167,100,337,7338
360007702458,36061001600,"Census Tract 16, New York County, New York",7675,1121,54,6167,100,337,7338
360007706169,36061001600,"Census Tract 16, New York County, New York",7675,1121,54,6167,100,337,7338
360007604869,36061002000,"Census Tract 20, New York County, New York",4872,1227,994,957,1384,3147,1725
360013504596,36061002000,"Census Tract 20, New York County, New York",4872,1227,994,957,1384,3147,1725
360007706130,36061001501,"Census Tract 15.01, New York County, New York",6006,3759,381,1575,166,534,5472
360007605615,36061002800,"Census Tract 28, New York County, New York",7409,3074,860,939,2231,3530,3879
360007602157,36061002800,"Census Tract 28, New York County, New York",7409,3074,860,939,2231,3530,3879
360007605617,36061002800,"Census Tract 28, New York County, New York",7409,3074,860,939,2231,3530,3879
360007603352,36061003601,"Census Tract 36.01, New York County, New York",3266,1493,387,719,456,1156,2110
360007606296,36061003601,"Census Tract 36.01, New York County, New York",3266,1493,387,719,456,1156,2110
360007600624,36061003001,"Census Tract 30.01, New York County, New York",4215,2566,82,1144,271,730,3485
360007601275,36061003001,"Census Tract 30.01, New York County, New York",4215,2566,82,1144,271,730,3485
360007602104,36061003001,"Census Tract 30.01, New York County, New York",4215,2566,82,1144,271,730,3485
360007606021,36061003001,"Census Tract 30.01, New York County, New York",4215,2566,82,1144,271,730,3485
360013502870,36061003800,"Census Tract 38, New York County, New York",8407,6071,443,1368,106,841,7566
360007702042,36061002700,"Census Tract 27, New York County, New York",1238,217,10,943,14,15,1223
360007702540,36061003900,"Census Tract 39, New York County, New York",5155,3997,173,461,131,598,4557
360104306268,36061003900,"Census Tract 39, New York County, New York",5155,3997,173,461,131,598,4557
360104506244,36061003100,"Census Tract 31, New York County, New York",2701,1867,170,514,18,244,2457
360007702034,36061002900,"Census Tract 29, New York County, New York",5841,582,706,4118,160,597,5244
360007702433,36061007000,"Census Tract 70, New York County, New York",7977,5782,120,1689,144,242,7735
360007702177,36061006400,"Census Tract 64, New York County, New York",7634,6021,284,879,57,431,7203
360007704454,36061006400,"Census Tract 64, New York County, New York",7634,6021,284,879,57,431,7203
360007704408,36061006400,"Census Tract 64, New York County, New York",7634,6021,284,879,57,431,7203
360007705767,36061006400,"Census Tract 64, New York County, New York",7634,6021,284,879,57,431,7203
360007704447,36061006400,"Census Tract 64, New York County, New York",7634,6021,284,879,57,431,7203
360007706125,36061006400,"Census Tract 64, New York County, New York",7634,6021,284,879,57,431,7203
360007705522,36061005700,"Census Tract 57, New York County, New York",2928,2417,70,306,7,173,2755
360007700584,36061005800,"Census Tract 58, New York County, New York",3006,2084,61,692,89,97,2909
360007702862,36061006800,"Census Tract 68, New York County, New York",6973,5383,527,772,230,576,6397
360007702856,36061006800,"Census Tract 68, New York County, New York",6973,5383,527,772,230,576,6397
360007700649,36061006700,"Census Tract 67, New York County, New York",5006,4325,176,331,0,208,4798
360013502026,36061006700,"Census Tract 67, New York County, New York",5006,4325,176,331,0,208,4798
360007702049,36061007300,"Census Tract 73, New York County, New York",5774,5080,173,315,164,468,5306
360007705768,36061007300,"Census Tract 73, New York County, New York",5774,5080,173,315,164,468,5306
360007702184,36061007100,"Census Tract 71, New York County, New York",5987,4863,83,765,77,219,5768
360009702543,36047043700,"Census Tract 437, Kings County, New York",6063,2958,1829,84,1086,3791,2272
360101706172,36047043700,"Census Tract 437, Kings County, New York",6063,2958,1829,84,1086,3791,2272
360007700637,36061008100,"Census Tract 81, New York County, New York",8799,7200,217,675,376,924,7875
360007701713,36061011900,"Census Tract 119, New York County, New York",1071,511,436,17,62,254,817
360007701299,36061011900,"Census Tract 119, New York County, New York",1071,511,436,17,62,254,817
360007702414,36061013300,"Census Tract 133, New York County, New York",5226,3638,226,704,367,1207,4019
360013503340,36061013300,"Census Tract 133, New York County, New York",5226,3638,226,704,367,1207,4019
360007704519,36061012700,"Census Tract 127, New York County, New York",6635,4427,358,963,419,1527,5108
360007701723,36061012700,"Census Tract 127, New York County, New York",6635,4427,358,963,419,1527,5108
360007704407,36061012700,"Census Tract 127, New York County, New York",6635,4427,358,963,419,1527,5108
360007706126,36061012700,"Census Tract 127, New York County, New York",6635,4427,358,963,419,1527,5108
360007706251,36061012700,"Census Tract 127, New York County, New York",6635,4427,358,963,419,1527,5108
360007702597,36061013400,"Census Tract 134, New York County, New York",11195,9825,99,685,130,783,10412
360007700582,36061013700,"Census Tract 137, New York County, New York",6977,5469,97,1273,54,374,6603
360007705084,36061013200,"Census Tract 132, New York County, New York",9869,8860,21,668,81,768,9101
360007704405,36061013200,"Census Tract 132, New York County, New York",9869,8860,21,668,81,768,9101
360007702569,36061013200,"Census Tract 132, New York County, New York",9869,8860,21,668,81,768,9101
360007706210,36061013200,"Census Tract 132, New York County, New York",9869,8860,21,668,81,768,9101
360007702225,36061012900,"Census Tract 129, New York County, New York",5285,3502,336,991,372,780,4505
360007705500,36061013500,"Census Tract 135, New York County, New York",6053,4010,828,762,306,2380,3673
360007705626,36061013500,"Census Tract 135, New York County, New York",6053,4010,828,762,306,2380,3673
360007705622,36061013500,"Census Tract 135, New York County, New York",6053,4010,828,762,306,2380,3673
360007705624,36061013500,"Census Tract 135, New York County, New York",6053,4010,828,762,306,2380,3673
360007705769,36061013500,"Census Tract 135, New York County, New York",6053,4010,828,762,306,2380,3673
360013502601,36061014802,"Census Tract 148.02, New York County, New York",7125,5997,89,658,23,364,6761
360007706166,36061015400,"Census Tract 154, New York County, New York",14969,12088,559,1763,13,1864,13105
360007703548,36061015801,"Census Tract 158.01, New York County, New York",5585,4992,232,228,44,366,5219
360007702675,36061015801,"Census Tract 158.01, New York County, New York",5585,4992,232,228,44,366,5219
360007803572,36061016100,"Census Tract 161, New York County, New York",6563,5723,93,491,119,220,6343
360007802197,36061016100,"Census Tract 161, New York County, New York",6563,5723,93,491,119,220,6343
360007802335,36061016100,"Census Tract 161, New York County, New York",6563,5723,93,491,119,220,6343
360007806135,36061016100,"Census Tract 161, New York County, New York",6563,5723,93,491,119,220,6343
360007806187,36061016100,"Census Tract 161, New York County, New York",6563,5723,93,491,119,220,6343
360007805638,36061014900,"Census Tract 149, New York County, New York",5897,4864,106,745,35,395,5502
360007802677,36061015500,"Census Tract 155, New York County, New York",10244,8492,169,1040,163,488,9756
360007803552,36061015500,"Census Tract 155, New York County, New York",10244,8492,169,1040,163,488,9756
360007805114,36061015100,"Census Tract 151, New York County, New York",7480,4245,815,1338,626,2352,5128
360007805505,36061015100,"Census Tract 151, New York County, New York",7480,4245,815,1338,626,2352,5128
360007804458,36061015100,"Census Tract 151, New York County, New York",7480,4245,815,1338,626,2352,5128
360007800592,36061015100,"Census Tract 151, New York County, New York",7480,4245,815,1338,626,2352,5128
360007805113,36061015100,"Census Tract 151, New York County, New York",7480,4245,815,1338,626,2352,5128
360007805630,36061015100,"Census Tract 151, New York County, New York",7480,4245,815,1338,626,2352,5128
360007805774,36061015100,"Census Tract 151, New York County, New York",7480,4245,815,1338,626,2352,5128
360007905631,36061017000,"Census Tract 170, New York County, New York",7598,1841,2429,1158,1756,3542,4056
360003904439,36061017000,"Census Tract 170, New York County, New York",7598,1841,2429,1158,1756,3542,4056
360007900593,36061017000,"Census Tract 170, New York County, New York",7598,1841,2429,1158,1756,3542,4056
360007906003,36061017000,"Census Tract 170, New York County, New York",7598,1841,2429,1158,1756,3542,4056
360007906022,36061017000,"Census Tract 170, New York County, New York",7598,1841,2429,1158,1756,3542,4056
360007803622,36061017700,"Census Tract 177, New York County, New York",9426,5486,1691,752,831,2772,6654
360007803579,36061017700,"Census Tract 177, New York County, New York",9426,5486,1691,752,831,2772,6654
360007803607,36061017700,"Census Tract 177, New York County, New York",9426,5486,1691,752,831,2772,6654
360007803616,36061017700,"Census Tract 177, New York County, New York",9426,5486,1691,752,831,2772,6654
360007802327,36061017700,"Census Tract 177, New York County, New York",9426,5486,1691,752,831,2772,6654
360007802593,36061017300,"Census Tract 173, New York County, New York",8968,6784,604,843,351,1541,7427
360007902294,36061016600,"Census Tract 166, New York County, New York",7693,3662,1213,381,2189,4218,3475
360007902246,36061018200,"Census Tract 182, New York County, New York",6553,1376,1784,126,3133,4111,2442
360004704413,36061016800,"Census Tract 168, New York County, New York",4974,1768,2005,218,802,2004,2970
360007902605,36061016800,"Census Tract 168, New York County, New York",4974,1768,2005,218,802,2004,2970
360007905635,36061016800,"Census Tract 168, New York County, New York",4974,1768,2005,218,802,2004,2970
360013501932,36061017100,"Census Tract 171, New York County, New York",9441,7657,823,487,51,968,8473
360007904518,36061017800,"Census Tract 178, New York County, New York",3931,1621,832,199,1093,1897,2034
360007905634,36061017800,"Census Tract 178, New York County, New York",3931,1621,832,199,1093,1897,2034
360007902529,36061016200,"Census Tract 162, New York County, New York",8993,2452,3944,425,1882,4238,4755
360014205779,36061016200,"Census Tract 162, New York County, New York",8993,2452,3944,425,1882,4238,4755
360007902223,36061016200,"Census Tract 162, New York County, New York",8993,2452,3944,425,1882,4238,4755
360007902927,36061016200,"Census Tract 162, New York County, New York",8993,2452,3944,425,1882,4238,4755
360007904412,36061016200,"Census Tract 162, New York County, New York",8993,2452,3944,425,1882,4238,4755
360007906016,36061016200,"Census Tract 162, New York County, New York",8993,2452,3944,425,1882,4238,4755
360103606225,36061016200,"Census Tract 162, New York County, New York",8993,2452,3944,425,1882,4238,4755
360007802584,36061018500,"Census Tract 185, New York County, New York",5296,3538,749,670,42,341,4955
360007902560,36061018800,"Census Tract 188, New York County, New York",5570,1963,1360,233,1876,3044,2526
360007902061,36061019600,"Census Tract 196, New York County, New York",4245,869,1217,255,1610,2515,1730
360007906096,36061019600,"Census Tract 196, New York County, New York",4245,869,1217,255,1610,2515,1730
360006804870,36061019400,"Census Tract 194, New York County, New York",6694,821,2707,216,2737,3679,3015
360014105778,36061019400,"Census Tract 194, New York County, New York",6694,821,2707,216,2737,3679,3015
360007902366,36061019400,"Census Tract 194, New York County, New York",6694,821,2707,216,2737,3679,3015
360007902200,36061019400,"Census Tract 194, New York County, New York",6694,821,2707,216,2737,3679,3015
360007900579,36061019400,"Census Tract 194, New York County, New York",6694,821,2707,216,2737,3679,3015
360007802235,36061019300,"Census Tract 193, New York County, New York",9305,4547,1937,577,1867,4219,5086
360007805629,36061019500,"Census Tract 195, New York County, New York",7911,5670,653,1076,253,1674,6237
360007802591,36061019500,"Census Tract 195, New York County, New York",7911,5670,653,1076,253,1674,6237
360013805775,36061018600,"Census Tract 186, New York County, New York",7245,1051,4271,266,1518,2478,4767
360007802640,36061018600,"Census Tract 186, New York County, New York",7245,1051,4271,266,1518,2478,4767
360007802700,36061018600,"Census Tract 186, New York County, New York",7245,1051,4271,266,1518,2478,4767
360007803603,36061018300,"Census Tract 183, New York County, New York",8382,6254,642,905,439,1433,6949
360007802303,36061018300,"Census Tract 183, New York County, New York",8382,6254,642,905,439,1433,6949
360008102164,36061019701,"Census Tract 197.01, New York County, New York",898,551,73,216,0,197,701
360007905632,36061019200,"Census Tract 192, New York County, New York",4103,509,1750,190,1361,2283,1820
360007902418,36061019200,"Census Tract 192, New York County, New York",4103,509,1750,190,1361,2283,1820
360007902694,36061019200,"Census Tract 192, New York County, New York",4103,509,1750,190,1361,2283,1820
360007805627,36061021800,"Census Tract 218, New York County, New York",7381,1549,4583,189,835,1124,6257
360007800687,36061021800,"Census Tract 218, New York County, New York",7381,1549,4583,189,835,1124,6257
360006104438,36061021800,"Census Tract 218, New York County, New York",7381,1549,4583,189,835,1124,6257
360008205526,36061020901,"Census Tract 209.01, New York County, New York",3987,505,2246,44,1159,1682,2305
360008102462,36061020901,"Census Tract 209.01, New York County, New York",3987,505,2246,44,1159,1682,2305
360008105944,36061020901,"Census Tract 209.01, New York County, New York",3987,505,2246,44,1159,1682,2305
360008102455,36061022102,"Census Tract 221.02, New York County, New York",2392,560,1458,128,104,97,2295
360008105636,36061022102,"Census Tract 221.02, New York County, New York",2392,560,1458,128,104,97,2295
360008102938,36061022102,"Census Tract 221.02, New York County, New York",2392,560,1458,128,104,97,2295
360008105639,36061022102,"Census Tract 221.02, New York County, New York",2392,560,1458,128,104,97,2295
360100906212,36061022102,"Census Tract 221.02, New York County, New York",2392,560,1458,128,104,97,2295
360008100590,36061020600,"Census Tract 206, New York County, New York",3025,400,2232,109,151,439,2586
360008102489,36061020600,"Census Tract 206, New York County, New York",3025,400,2232,109,151,439,2586
360014005777,36061020600,"Census Tract 206, New York County, New York",3025,400,2232,109,151,439,2586
360008105758,36061020600,"Census Tract 206, New York County, New York",3025,400,2232,109,151,439,2586
360098706124,36061020600,"Census Tract 206, New York County, New York",3025,400,2232,109,151,439,2586
360008106256,36061020600,"Census Tract 206, New York County, New York",3025,400,2232,109,151,439,2586
360008102176,36061022400,"Census Tract 224, New York County, New York",7344,610,4901,112,1398,2135,5209
360008102670,36061021200,"Census Tract 212, New York County, New York",4211,407,3118,215,290,810,3401
360014305781,36061022302,"Census Tract 223.02, New York County, New York",3426,968,1139,114,842,1944,1482
360008101993,36061022302,"Census Tract 223.02, New York County, New York",3426,968,1139,114,842,1944,1482
360008106257,36061022302,"Census Tract 223.02, New York County, New York",3426,968,1139,114,842,1944,1482
360008102475,36061021703,"Census Tract 217.03, New York County, New York",0,0,0,0,0,0,0
360008105116,36061021703,"Census Tract 217.03, New York County, New York",0,0,0,0,0,0,0
360008304305,36061021703,"Census Tract 217.03, New York County, New York",0,0,0,0,0,0,0
360008304517,36061021703,"Census Tract 217.03, New York County, New York",0,0,0,0,0,0,0
360008105945,36061021900,"Census Tract 219, New York County, New York",6089,645,2565,147,2473,3343,2746
360008104436,36061021900,"Census Tract 219, New York County, New York",6089,645,2565,147,2473,3343,2746
360008105934,36061021900,"Census Tract 219, New York County, New York",6089,645,2565,147,2473,3343,2746
360008104690,36061022800,"Census Tract 228, New York County, New York",5714,649,3947,132,448,779,4935
360008105115,36061022800,"Census Tract 228, New York County, New York",5714,649,3947,132,448,779,4935
360008105117,36061022600,"Census Tract 226, New York County, New York",4053,574,2843,66,428,680,3373
360015805847,36061022600,"Census Tract 226, New York County, New York",4053,574,2843,66,428,680,3373
360008105900,36061022600,"Census Tract 226, New York County, New York",4053,574,2843,66,428,680,3373
360095806007,36061022600,"Census Tract 226, New York County, New York",4053,574,2843,66,428,680,3373
360101006183,36061022600,"Census Tract 226, New York County, New York",4053,574,2843,66,428,680,3373
360015302507,36047152200,"Census Tract 1522, Kings County, New York",3563,1736,687,745,222,205,3358
360013502124,36085019800,"Census Tract 198, Richmond County, New York",6588,6078,94,241,47,442,6146
360010301966,36085019800,"Census Tract 198, Richmond County, New York",6588,6078,94,241,47,442,6146
360010302051,36085019800,"Census Tract 198, Richmond County, New York",6588,6078,94,241,47,442,6146
360010302883,36085019800,"Census Tract 198, Richmond County, New York",6588,6078,94,241,47,442,6146
360008405988,36005007700,"Census Tract 77, Bronx County, New York",1904,219,524,0,1084,1363,541
360008405785,36005007700,"Census Tract 77, Bronx County, New York",1904,219,524,0,1084,1363,541
360008405786,36005007700,"Census Tract 77, Bronx County, New York",1904,219,524,0,1084,1363,541
360013503373,36005007700,"Census Tract 77, Bronx County, New York",1904,219,524,0,1084,1363,541
360008404460,36005007300,"Census Tract 73, Bronx County, New York",3735,330,1393,0,1929,2465,1270
360008402056,36005007300,"Census Tract 73, Bronx County, New York",3735,330,1393,0,1929,2465,1270
360096306039,36005007300,"Census Tract 73, Bronx County, New York",3735,330,1393,0,1929,2465,1270
360008402043,36005006700,"Census Tract 67, Bronx County, New York",7782,1012,2954,14,3139,5137,2645
360008401909,36005006700,"Census Tract 67, Bronx County, New York",7782,1012,2954,14,3139,5137,2645
360008406253,36005006700,"Census Tract 67, Bronx County, New York",7782,1012,2954,14,3139,5137,2645
360008405533,36005007500,"Census Tract 75, Bronx County, New York",4932,651,2099,0,2006,3135,1797
360008402578,36005007900,"Census Tract 79, Bronx County, New York",6099,1100,1964,0,2907,4576,1523
360008402122,36005007900,"Census Tract 79, Bronx County, New York",6099,1100,1964,0,2907,4576,1523
360008502168,36005007800,"Census Tract 78, Bronx County, New York",6868,1258,1616,648,3006,4363,2505
360008402147,36005006100,"Census Tract 61, Bronx County, New York",4007,175,3392,0,258,536,3471
360005404452,36005006100,"Census Tract 61, Bronx County, New York",4007,175,3392,0,258,536,3471
360008401983,36005006100,"Census Tract 61, Bronx County, New York",4007,175,3392,0,258,536,3471
360008406020,36005006100,"Census Tract 61, Bronx County, New York",4007,175,3392,0,258,536,3471
360096706008,36005006100,"Census Tract 61, Bronx County, New York",4007,175,3392,0,258,536,3471
360008405512,36005007100,"Census Tract 71, Bronx County, New York",2358,305,1070,4,892,1432,926
360008405761,36005007100,"Census Tract 71, Bronx County, New York",2358,305,1070,4,892,1432,926
360008405187,36005007100,"Census Tract 71, Bronx County, New York",2358,305,1070,4,892,1432,926
360008405517,36005007100,"Census Tract 71, Bronx County, New York",2358,305,1070,4,892,1432,926
360008603742,36005019700,"Census Tract 197, Bronx County, New York",7084,941,2345,402,3106,4622,2462
360008602465,36005019900,"Census Tract 199, Bronx County, New York",7635,928,2575,0,3606,4962,2673
360008604459,36005021302,"Census Tract 213.02, Bronx County, New York",6250,721,2901,59,2499,3669,2581
360015005825,36047114400,"Census Tract 1144, Kings County, New York",2700,475,1743,0,430,938,1762
360012002889,36047114400,"Census Tract 1144, Kings County, New York",2700,475,1743,0,430,938,1762
360012002800,36047114400,"Census Tract 1144, Kings County, New York",2700,475,1743,0,430,938,1762
360009506200,36047114400,"Census Tract 1144, Kings County, New York",2700,475,1743,0,430,938,1762
360008602073,36005020100,"Census Tract 201, Bronx County, New York",4292,684,1420,26,2044,2935,1357
360008600728,36005022702,"Census Tract 227.02, Bronx County, New York",1525,288,627,15,521,820,705
360008605542,36005022300,"Census Tract 223, Bronx County, New York",5214,934,2081,91,1734,3106,2108
360012105722,36047092400,"Census Tract 924, Kings County, New York",3133,37,2979,0,117,262,2871
360013504782,36047092400,"Census Tract 924, Kings County, New York",3133,37,2979,0,117,262,2871
360012104886,36047092400,"Census Tract 924, Kings County, New York",3133,37,2979,0,117,262,2871
360012102819,36047092400,"Census Tract 924, Kings County, New York",3133,37,2979,0,117,262,2871
360012105242,36047092400,"Census Tract 924, Kings County, New York",3133,37,2979,0,117,262,2871
360012106175,36047092400,"Census Tract 924, Kings County, New York",3133,37,2979,0,117,262,2871
360008604876,36005021502,"Census Tract 215.02, Bronx County, New York",6110,575,1688,0,3633,4256,1854
360008603764,36005021502,"Census Tract 215.02, Bronx County, New York",6110,575,1688,0,3633,4256,1854
360008604808,36005021502,"Census Tract 215.02, Bronx County, New York",6110,575,1688,0,3633,4256,1854
360008605981,36005021502,"Census Tract 215.02, Bronx County, New York",6110,575,1688,0,3633,4256,1854
360008605669,36005022500,"Census Tract 225, Bronx County, New York",8071,1050,2783,0,4019,5511,2560
360008605671,36005022500,"Census Tract 225, Bronx County, New York",8071,1050,2783,0,4019,5511,2560
360008605882,36005022500,"Census Tract 225, Bronx County, New York",8071,1050,2783,0,4019,5511,2560
360008605176,36005022500,"Census Tract 225, Bronx County, New York",8071,1050,2783,0,4019,5511,2560
360008605177,36005022500,"Census Tract 225, Bronx County, New York",8071,1050,2783,0,4019,5511,2560
360008605178,36005022500,"Census Tract 225, Bronx County, New York",8071,1050,2783,0,4019,5511,2560
360006604877,36005021900,"Census Tract 219, Bronx County, New York",1205,220,206,0,736,1070,135
360011902144,36047056100,"Census Tract 561, Kings County, New York",2891,2580,62,140,42,246,2645
360009001332,36005022000,"Census Tract 220, Bronx County, New York",2070,281,417,135,1183,1515,555
360008702060,36005028700,"Census Tract 287, Bronx County, New York",3489,1449,480,239,1090,1967,1522
360008700183,36005024100,"Census Tract 241, Bronx County, New York",6421,516,1898,50,3513,4607,1814
360009004878,36005036901,"Census Tract 369.01, Bronx County, New York",2284,173,792,70,1225,1774,510
360009002706,36005036901,"Census Tract 369.01, Bronx County, New York",2284,173,792,70,1225,1774,510
360009003353,36005005400,"Census Tract 54, Bronx County, New York",6334,991,1717,145,2714,4551,1783
360009003369,36005005400,"Census Tract 54, Bronx County, New York",6334,991,1717,145,2714,4551,1783
360008702063,36005041500,"Census Tract 415, Bronx County, New York",5449,821,1062,303,2991,3786,1663
360008502632,36005001600,"Census Tract 16, Bronx County, New York",5412,1855,1806,0,1660,3694,1718
360008505983,36005001600,"Census Tract 16, Bronx County, New York",5412,1855,1806,0,1660,3694,1718
360008505984,36005001600,"Census Tract 16, Bronx County, New York",5412,1855,1806,0,1660,3694,1718
360008505186,36005001600,"Census Tract 16, Bronx County, New York",5412,1855,1806,0,1660,3694,1718
360008505507,36005001600,"Census Tract 16, Bronx County, New York",5412,1855,1806,0,1660,3694,1718
360008505654,36005001600,"Census Tract 16, Bronx County, New York",5412,1855,1806,0,1660,3694,1718
360008502285,36005001600,"Census Tract 16, Bronx County, New York",5412,1855,1806,0,1660,3694,1718
360008505660,36005001600,"Census Tract 16, Bronx County, New York",5412,1855,1806,0,1660,3694,1718
360008505661,36005001600,"Census Tract 16, Bronx County, New York",5412,1855,1806,0,1660,3694,1718
360008506221,36005001600,"Census Tract 16, Bronx County, New York",5412,1855,1806,0,1660,3694,1718
360008505985,36005000400,"Census Tract 4, Bronx County, New York",5572,1674,1996,36,1800,3533,2039
360008505986,36005000400,"Census Tract 4, Bronx County, New York",5572,1674,1996,36,1800,3533,2039
360008502479,36005008500,"Census Tract 85, Bronx County, New York",6324,740,1407,65,4005,5027,1297
360008602048,36005014900,"Census Tract 149, Bronx County, New York",4531,368,1857,6,1998,2664,1867
360008605666,36005014900,"Census Tract 149, Bronx County, New York",4531,368,1857,6,1998,2664,1867
360008605561,36005014900,"Census Tract 149, Bronx County, New York",4531,368,1857,6,1998,2664,1867
360008602413,36005014900,"Census Tract 149, Bronx County, New York",4531,368,1857,6,1998,2664,1867
360009002373,36005015500,"Census Tract 155, Bronx County, New York",3058,497,766,26,1699,2320,738
360009005682,36005015500,"Census Tract 155, Bronx County, New York",3058,497,766,26,1699,2320,738
360009005792,36005015500,"Census Tract 155, Bronx County, New York",3058,497,766,26,1699,2320,738
360009006275,36005015500,"Census Tract 155, Bronx County, New York",3058,497,766,26,1699,2320,738
360008605175,36005013500,"Census Tract 135, Bronx County, New York",3957,359,1463,0,1770,2618,1339
360008605547,36005013500,"Census Tract 135, Bronx County, New York",3957,359,1463,0,1770,2618,1339
360009002672,36005013500,"Census Tract 135, Bronx County, New York",3957,359,1463,0,1770,2618,1339
360009001309,36005013500,"Census Tract 135, Bronx County, New York",3957,359,1463,0,1770,2618,1339
360008605693,36005013500,"Census Tract 135, Bronx County, New York",3957,359,1463,0,1770,2618,1339
360008604879,36005013500,"Census Tract 135, Bronx County, New York",3957,359,1463,0,1770,2618,1339
360008405189,36005013500,"Census Tract 135, Bronx County, New York",3957,359,1463,0,1770,2618,1339
360009006133,36005013500,"Census Tract 135, Bronx County, New York",3957,359,1463,0,1770,2618,1339
360013504468,36005015100,"Census Tract 151, Bronx County, New York",5662,637,2514,0,2254,3236,2426
360008605795,36005016500,"Census Tract 165, Bronx County, New York",1296,59,763,11,452,757,539
360008605191,36005016500,"Census Tract 165, Bronx County, New York",1296,59,763,11,452,757,539
360008600795,36005016500,"Census Tract 165, Bronx County, New York",1296,59,763,11,452,757,539
360009005679,36005016100,"Census Tract 161, Bronx County, New York",4130,452,1189,34,2380,3012,1118
360008505652,36005008900,"Census Tract 89, Bronx County, New York",3540,641,855,12,1717,2848,692
360015102682,36047016600,"Census Tract 166, Kings County, New York",2239,2167,0,38,6,271,1968
360013504409,36047110400,"Census Tract 1104, Kings County, New York",4725,179,3895,0,626,1004,3721
360012000813,36047110400,"Census Tract 1104, Kings County, New York",4725,179,3895,0,626,1004,3721
360013504476,36047110400,"Census Tract 1104, Kings County, New York",4725,179,3895,0,626,1004,3721
360012002595,36047110400,"Census Tract 1104, Kings County, New York",4725,179,3895,0,626,1004,3721
360012002710,36047110400,"Census Tract 1104, Kings County, New York",4725,179,3895,0,626,1004,3721
360012002810,36047110400,"Census Tract 1104, Kings County, New York",4725,179,3895,0,626,1004,3721
360103106238,36047110400,"Census Tract 1104, Kings County, New York",4725,179,3895,0,626,1004,3721
360013500812,36047011900,"Census Tract 119, Kings County, New York",1915,1217,60,88,406,733,1182
360008505655,36005008700,"Census Tract 87, Bronx County, New York",6406,958,1526,0,3763,4970,1436
360008505656,36005008700,"Census Tract 87, Bronx County, New York",6406,958,1526,0,3763,4970,1436
360008502968,36005008700,"Census Tract 87, Bronx County, New York",6406,958,1526,0,3763,4970,1436
360008505876,36005008700,"Census Tract 87, Bronx County, New York",6406,958,1526,0,3763,4970,1436
360009502360,36047030500,"Census Tract 305, Kings County, New York",5809,2190,2376,467,536,889,4920
360009102478,36047030500,"Census Tract 305, Kings County, New York",5809,2190,2376,467,536,889,4920
360012002684,36047111600,"Census Tract 1116, Kings County, New York",3406,547,2595,0,256,707,2699
360006304875,36005011502,"Census Tract 115.02, Bronx County, New York",4446,1126,1639,38,1400,3053,1393
360008402191,36005002500,"Census Tract 25, Bronx County, New York",5143,1394,1025,293,2293,4018,1125
360096006013,36005002500,"Census Tract 25, Bronx County, New York",5143,1394,1025,293,2293,4018,1125
360008405118,36005003900,"Census Tract 39, Bronx County, New York",6580,1721,1431,77,3318,5151,1429
360014405787,36005003900,"Census Tract 39, Bronx County, New York",6580,1721,1431,77,3318,5151,1429
360008402218,36005003900,"Census Tract 39, Bronx County, New York",6580,1721,1431,77,3318,5151,1429
360008402143,36005003900,"Census Tract 39, Bronx County, New York",6580,1721,1431,77,3318,5151,1429
360095906073,36005003900,"Census Tract 39, Bronx County, New York",6580,1721,1431,77,3318,5151,1429
360101106211,36005003900,"Census Tract 39, Bronx County, New York",6580,1721,1431,77,3318,5151,1429
360008406041,36005003900,"Census Tract 39, Bronx County, New York",6580,1721,1431,77,3318,5151,1429
360013504522,36005003500,"Census Tract 35, Bronx County, New York",3753,373,1164,0,2027,2721,1032
360008402866,36005003500,"Census Tract 35, Bronx County, New York",3753,373,1164,0,2027,2721,1032
360008400794,36005003500,"Census Tract 35, Bronx County, New York",3753,373,1164,0,2027,2721,1032
360008405521,36005004300,"Census Tract 43, Bronx County, New York",5841,791,1762,0,2959,4484,1357
360008403738,36005004300,"Census Tract 43, Bronx County, New York",5841,791,1762,0,2959,4484,1357
360008405650,36005004300,"Census Tract 43, Bronx County, New York",5841,791,1762,0,2959,4484,1357
360104406248,36005004300,"Census Tract 43, Bronx County, New York",5841,791,1762,0,2959,4484,1357
360008402556,36005002300,"Census Tract 23, Bronx County, New York",4860,779,2369,0,1556,2985,1875
360008502401,36005002000,"Census Tract 20, Bronx County, New York",8959,1857,4016,290,2385,5264,3695
360008502456,36005004800,"Census Tract 48, Bronx County, New York",4024,551,875,162,2070,3022,1002
360008505657,36005004800,"Census Tract 48, Bronx County, New York",4024,551,875,162,2070,3022,1002
360008505565,36005002800,"Census Tract 28, Bronx County, New York",5746,189,4409,65,727,1438,4308
360008505789,36005002800,"Census Tract 28, Bronx County, New York",5746,189,4409,65,727,1438,4308
360008502354,36005002800,"Census Tract 28, Bronx County, New York",5746,189,4409,65,727,1438,4308
360094305973,36005002800,"Census Tract 28, Bronx County, New York",5746,189,4409,65,727,1438,4308
360102506233,36005002800,"Census Tract 28, Bronx County, New York",5746,189,4409,65,727,1438,4308
360008506258,36005002800,"Census Tract 28, Bronx County, New York",5746,189,4409,65,727,1438,4308
360008602188,36005016900,"Census Tract 169, Bronx County, New York",1498,129,877,0,446,662,836
360004904470,36005016900,"Census Tract 169, Bronx County, New York",1498,129,877,0,446,662,836
360008603767,36005016700,"Census Tract 167, Bronx County, New York",2433,209,1485,0,666,933,1500
360008603780,36005016700,"Census Tract 167, Bronx County, New York",2433,209,1485,0,666,933,1500
360008605673,36005016700,"Census Tract 167, Bronx County, New York",2433,209,1485,0,666,933,1500
360008605793,36005016700,"Census Tract 167, Bronx County, New York",2433,209,1485,0,666,933,1500
360008605861,36005016700,"Census Tract 167, Bronx County, New York",2433,209,1485,0,666,933,1500
360004204466,36005016700,"Census Tract 167, Bronx County, New York",2433,209,1485,0,666,933,1500
360008605667,36005017300,"Census Tract 173, Bronx County, New York",6697,1424,1947,202,2767,4488,2209
360008605665,36005017300,"Census Tract 173, Bronx County, New York",6697,1424,1947,202,2767,4488,2209
360008602528,36005017300,"Census Tract 173, Bronx County, New York",6697,1424,1947,202,2767,4488,2209
360008604461,36005017500,"Census Tract 175, Bronx County, New York",7021,616,3021,0,2924,4446,2575
360008605664,36005017500,"Census Tract 175, Bronx County, New York",7021,616,3021,0,2924,4446,2575
360008602232,36005017500,"Census Tract 175, Bronx County, New York",7021,616,3021,0,2924,4446,2575
360013504597,36005016600,"Census Tract 166, Bronx County, New York",2292,1174,176,222,608,1097,1195
360008602298,36005018900,"Census Tract 189, Bronx County, New York",8389,1683,2349,73,4110,6162,2227
360008502085,36005018400,"Census Tract 184, Bronx County, New York",3928,2653,198,74,941,1488,2440
360008501964,36005019400,"Census Tract 194, Bronx County, New York",2282,803,245,38,911,1370,912
360008505659,36005019400,"Census Tract 194, Bronx County, New York",2282,803,245,38,911,1370,912
360010302044,36085024401,"Census Tract 244.01, Richmond County, New York",6199,5953,0,128,17,348,5851
360010304816,36085024401,"Census Tract 244.01, Richmond County, New York",6199,5953,0,128,17,348,5851
360010301970,36085024401,"Census Tract 244.01, Richmond County, New York",6199,5953,0,128,17,348,5851
360009002541,36005012701,"Census Tract 127.01, Bronx County, New York",2117,410,580,48,939,1606,511
360009602759,36047094600,"Census Tract 946, Kings County, New York",1985,176,1689,0,4,156,1829
360101306203,36047094600,"Census Tract 946, Kings County, New York",1985,176,1689,0,4,156,1829
360015201943,36047076800,"Census Tract 768, Kings County, New York",3512,2789,46,393,190,295,3217
360015202676,36047076800,"Census Tract 768, Kings County, New York",3512,2789,46,393,190,295,3217
360013502844,36005012300,"Census Tract 123, Bronx County, New York",4144,257,1335,29,2311,2787,1357
360012004316,36047119800,"Census Tract 1198, Kings County, New York",3120,964,1474,57,467,1601,1519
360008700127,36005041100,"Census Tract 411, Bronx County, New York",2928,513,692,134,1447,1887,1041
360008703795,36005040900,"Census Tract 409, Bronx County, New York",3500,629,2521,89,117,440,3060
360008705556,36005040900,"Census Tract 409, Bronx County, New York",3500,629,2521,89,117,440,3060
360008705799,36005040900,"Census Tract 409, Bronx County, New York",3500,629,2521,89,117,440,3060
360008705938,36005040900,"Census Tract 409, Bronx County, New York",3500,629,2521,89,117,440,3060
360008701922,36005040900,"Census Tract 409, Bronx County, New York",3500,629,2521,89,117,440,3060
360008701940,36005040900,"Census Tract 409, Bronx County, New York",3500,629,2521,89,117,440,3060
360008702332,36005040900,"Census Tract 409, Bronx County, New York",3500,629,2521,89,117,440,3060
360008705181,36005040900,"Census Tract 409, Bronx County, New York",3500,629,2521,89,117,440,3060
360008705190,36005040900,"Census Tract 409, Bronx County, New York",3500,629,2521,89,117,440,3060
360008705557,36005040900,"Census Tract 409, Bronx County, New York",3500,629,2521,89,117,440,3060
360008702244,36005042902,"Census Tract 429.02, Bronx County, New York",4086,897,1383,183,1371,2236,1850
360009002279,36005036300,"Census Tract 363, Bronx County, New York",7855,970,1214,12,5407,6642,1213
360009005970,36005036300,"Census Tract 363, Bronx County, New York",7855,970,1214,12,5407,6642,1213
360008702179,36005042500,"Census Tract 425, Bronx County, New York",6637,1565,959,419,3092,4428,2209
360013502224,36005042500,"Census Tract 425, Bronx County, New York",6637,1565,959,419,3092,4428,2209
360008702316,36005041900,"Census Tract 419, Bronx County, New York",6965,1801,1367,1100,2361,3702,3263
360008704695,36005041900,"Census Tract 419, Bronx County, New York",6965,1801,1367,1100,2361,3702,3263
360009002059,36005035900,"Census Tract 359, Bronx County, New York",1902,186,630,0,1047,1286,616
360008802282,36005042600,"Census Tract 426, Bronx County, New York",7198,221,6284,234,424,705,6493
360008705797,36005035100,"Census Tract 351, Bronx County, New York",3202,2068,256,216,607,980,2222
360008802092,36005041400,"Census Tract 414, Bronx County, New York",4834,487,2922,344,974,1178,3656
360009002194,36005036902,"Census Tract 369.02, Bronx County, New York",2309,140,1148,0,839,1255,1054
360009005692,36005036902,"Census Tract 369.02, Bronx County, New York",2309,140,1148,0,839,1255,1054
360008802419,36005045800,"Census Tract 458, Bronx County, New York",5287,473,2512,0,2098,2930,2357
360008802100,36005045102,"Census Tract 451.02, Bronx County, New York",1847,1554,55,66,151,223,1624
360008802628,36005046201,"Census Tract 462.01, Bronx County, New York",28827,5610,16941,223,4916,9729,19098
360008805680,36005046201,"Census Tract 462.01, Bronx County, New York",28827,5610,16941,223,4916,9729,19098
360008800158,36005046201,"Census Tract 462.01, Bronx County, New York",28827,5610,16941,223,4916,9729,19098
360008801963,36005046201,"Census Tract 462.01, Bronx County, New York",28827,5610,16941,223,4916,9729,19098
360008801989,36005046201,"Census Tract 462.01, Bronx County, New York",28827,5610,16941,223,4916,9729,19098
360008802553,36005046201,"Census Tract 462.01, Bronx County, New York",28827,5610,16941,223,4916,9729,19098
360013504521,36005046201,"Census Tract 462.01, Bronx County, New York",28827,5610,16941,223,4916,9729,19098
360008805971,36005046202,"Census Tract 462.02, Bronx County, New York",8701,666,6184,60,1455,2323,6378
360013500554,36005046202,"Census Tract 462.02, Bronx County, New York",8701,666,6184,60,1455,2323,6378
360008806107,36005046202,"Census Tract 462.02, Bronx County, New York",8701,666,6184,60,1455,2323,6378
360009005690,36005037300,"Census Tract 373, Bronx County, New York",5096,921,1630,62,2085,3453,1643
360009002245,36005037300,"Census Tract 373, Bronx County, New York",5096,921,1630,62,2085,3453,1643
360008805568,36005037200,"Census Tract 372, Bronx County, New York",2280,212,1377,76,399,679,1601
360008805681,36005037200,"Census Tract 372, Bronx County, New York",2280,212,1377,76,399,679,1601
360008805684,36005037200,"Census Tract 372, Bronx County, New York",2280,212,1377,76,399,679,1601
360008805686,36005037200,"Census Tract 372, Bronx County, New York",2280,212,1377,76,399,679,1601
360008805543,36005037200,"Census Tract 372, Bronx County, New York",2280,212,1377,76,399,679,1601
360008805683,36005037200,"Census Tract 372, Bronx County, New York",2280,212,1377,76,399,679,1601
360008802185,36005037400,"Census Tract 374, Bronx County, New York",3525,297,2000,111,852,1479,2046
360008802517,36005048400,"Census Tract 484, Bronx County, New York",3779,356,2960,11,373,621,3158
360008905554,36005048400,"Census Tract 484, Bronx County, New York",3779,356,2960,11,373,621,3158
360008802417,36005048400,"Census Tract 484, Bronx County, New York",3779,356,2960,11,373,621,3158
360008806249,36005048400,"Census Tract 484, Bronx County, New York",3779,356,2960,11,373,621,3158
360008806259,36005048400,"Census Tract 484, Bronx County, New York",3779,356,2960,11,373,621,3158
360008405920,36005004100,"Census Tract 41, Bronx County, New York",6483,1781,2068,12,2353,4997,1486
360011005651,36005004100,"Census Tract 41, Bronx County, New York",6483,1781,2068,12,2353,4997,1486
360008405873,36005004100,"Census Tract 41, Bronx County, New York",6483,1781,2068,12,2353,4997,1486
360008802613,36005051600,"Census Tract 516, Bronx County, New York",4336,3544,58,18,675,938,3398
360008802323,36005024400,"Census Tract 244, Bronx County, New York",2588,1216,152,105,1105,1379,1209
360008806217,36005024400,"Census Tract 244, Bronx County, New York",2588,1216,152,105,1105,1379,1209
360008802368,36005031400,"Census Tract 314, Bronx County, New York",2336,1391,247,385,313,647,1689
360008502302,36005011900,"Census Tract 119, Bronx County, New York",5570,616,2003,18,2724,3747,1823
360012102590,36047089600,"Census Tract 896, Kings County, New York",3258,55,2904,184,115,115,3143
360012106012,36047089600,"Census Tract 896, Kings County, New York",3258,55,2904,184,115,115,3143
360012106026,36047089600,"Census Tract 896, Kings County, New York",3258,55,2904,184,115,115,3143
360009605958,36047088600,"Census Tract 886, Kings County, New York",4321,18,4040,0,139,406,3915
360094405974,36047088600,"Census Tract 886, Kings County, New York",4321,18,4040,0,139,406,3915
360009602721,36047088600,"Census Tract 886, Kings County, New York",4321,18,4040,0,139,406,3915
360009502649,36047089200,"Census Tract 892, Kings County, New York",3605,34,3472,0,28,187,3418
360100206167,36047089200,"Census Tract 892, Kings County, New York",3605,34,3472,0,28,187,3418
360096606069,36047089200,"Census Tract 892, Kings County, New York",3605,34,3472,0,28,187,3418
360009202139,36047004500,"Census Tract 45, Kings County, New York",3438,3074,44,147,65,233,3205
360015102638,36047006000,"Census Tract 60, Kings County, New York",2798,2284,12,340,45,368,2430
360009201377,36047006900,"Census Tract 69, Kings County, New York",3913,2781,119,212,236,863,3050
360009203389,36047006900,"Census Tract 69, Kings County, New York",3913,2781,119,212,236,863,3050
360009204890,36047006900,"Census Tract 69, Kings County, New York",3913,2781,119,212,236,863,3050
360009202993,36047008400,"Census Tract 84, Kings County, New York",3905,1453,37,131,2036,2923,982
360013502827,36047008400,"Census Tract 84, Kings County, New York",3905,1453,37,131,2036,2923,982
360009206111,36047008400,"Census Tract 84, Kings County, New York",3905,1453,37,131,2036,2923,982
360099106123,36047008400,"Census Tract 84, Kings County, New York",3905,1453,37,131,2036,2923,982
360015102385,36047006800,"Census Tract 68, Kings County, New York",5213,3392,92,835,663,1563,3650
360009202151,36047007500,"Census Tract 75, Kings County, New York",4909,3552,2,676,485,824,4085
360009205502,36047007500,"Census Tract 75, Kings County, New York",4909,3552,2,676,485,824,4085
360015106196,36047007200,"Census Tract 72, Kings County, New York",2284,522,47,762,920,1123,1161
360015106199,36047007200,"Census Tract 72, Kings County, New York",2284,522,47,762,920,1123,1161
360009204811,36047006300,"Census Tract 63, Kings County, New York",1943,1706,18,112,40,294,1649
360009205497,36047006300,"Census Tract 63, Kings County, New York",1943,1706,18,112,40,294,1649
360009202132,36047005900,"Census Tract 59, Kings County, New York",1280,895,194,45,97,212,1068
360099806114,36047005900,"Census Tract 59, Kings County, New York",1280,895,194,45,97,212,1068
360009206143,36047005900,"Census Tract 59, Kings County, New York",1280,895,194,45,97,212,1068
360015101916,36047007000,"Census Tract 70, Kings County, New York",2672,1778,125,581,90,425,2247
360009202359,36047009800,"Census Tract 98, Kings County, New York",7614,1729,162,3102,2313,4125,3489
360009205864,36047011000,"Census Tract 110, Kings County, New York",2482,816,68,732,822,1165,1317
360009102793,36047013100,"Census Tract 131, Kings County, New York",4107,2506,510,203,729,1053,3054
360009104483,36047012902,"Census Tract 129.02, Kings County, New York",1998,1320,229,112,253,487,1511
360013502311,36047012902,"Census Tract 129.02, Kings County, New York",1998,1320,229,112,253,487,1511
360009202607,36047010100,"Census Tract 101, Kings County, New York",4120,1888,101,60,1727,2732,1388
360009102490,36047012901,"Census Tract 129.01, Kings County, New York",2724,1331,119,196,978,1042,1682
360015105227,36047012000,"Census Tract 120, Kings County, New York",1311,90,0,1207,14,28,1283
360015102603,36047013400,"Census Tract 134, Kings County, New York",4029,2970,10,591,324,680,3349
360010102158,36081058200,"Census Tract 582, Queens County, New York",5398,165,4527,43,272,466,4932
360010105545,36081044400,"Census Tract 444, Queens County, New York",2843,315,714,682,957,1046,1797
360009901953,36081141700,"Census Tract 1417, Queens County, New York",4627,1696,73,2352,241,535,4092
360013504354,36081141700,"Census Tract 1417, Queens County, New York",4627,1696,73,2352,241,535,4092
360012302743,36081006202,"Census Tract 62.02, Queens County, New York",6988,4826,406,507,819,2408,4580
360007802023,36061016900,"Census Tract 169, New York County, New York",7811,6583,429,417,111,589,7222
360007802068,36061016900,"Census Tract 169, New York County, New York",7811,6583,429,417,111,589,7222
360007805773,36061016900,"Census Tract 169, New York County, New York",7811,6583,429,417,111,589,7222
360007806145,36061016900,"Census Tract 169, New York County, New York",7811,6583,429,417,111,589,7222
360007806146,36061016900,"Census Tract 169, New York County, New York",7811,6583,429,417,111,589,7222
360007806148,36061016900,"Census Tract 169, New York County, New York",7811,6583,429,417,111,589,7222
360007806185,36061016900,"Census Tract 169, New York County, New York",7811,6583,429,417,111,589,7222
360007902083,36061016400,"Census Tract 164, New York County, New York",6722,2051,1947,720,1733,3127,3595
360096406038,36061016400,"Census Tract 164, New York County, New York",6722,2051,1947,720,1733,3127,3595
00937133,36081077908,"Census Tract 779.08, Queens County, New York",4101,1326,899,1242,285,671,3430
00925875,36081025700,"Census Tract 257, Queens County, New York",1210,650,0,436,44,340,870
02047717,36081077907,"Census Tract 779.07, Queens County, New York",3149,2447,182,248,167,461,2688
BB081365,36081077907,"Census Tract 779.07, Queens County, New York",3149,2447,182,248,167,461,2688
A9702456,36081025100,"Census Tract 251, Queens County, New York",5560,2650,15,1972,852,1921,3639
00943894,36081025100,"Census Tract 251, Queens County, New York",5560,2650,15,1972,852,1921,3639
00925467,36081004001,"Census Tract 40.01, Queens County, New York",2018,605,61,433,751,1035,983
00925489,36081003400,"Census Tract 34, Queens County, New York",2064,646,108,463,638,1085,979
BB964100,36081024300,"Census Tract 243, Queens County, New York",5947,3278,27,2088,471,2140,3807
A1101665,36047021100,"Census Tract 211, Kings County, New York",1254,315,678,92,147,336,918
00925831,36081102900,"Census Tract 1029, Queens County, New York",3699,2715,67,695,171,805,2894
00925048,36081105900,"Census Tract 1059, Queens County, New York",3730,2456,1,956,123,340,3390
BB912090,36081103202,"Census Tract 1032.02, Queens County, New York",7099,3841,2182,58,776,2347,4752
A9105016,36081103202,"Census Tract 1032.02, Queens County, New York",7099,3841,2182,58,776,2347,4752
BB121771,36081103202,"Census Tract 1032.02, Queens County, New York",7099,3841,2182,58,776,2347,4752
A1101741,36081103202,"Census Tract 1032.02, Queens County, New York",7099,3841,2182,58,776,2347,4752
BB121761,36081028400,"Census Tract 284, Queens County, New York",4143,106,3519,0,473,387,3756
BB041325,36081028400,"Census Tract 284, Queens County, New York",4143,106,3519,0,473,387,3756
00925911,36081094700,"Census Tract 947, Queens County, New York",2502,1068,28,612,711,1018,1484
02047943,36081098100,"Census Tract 981, Queens County, New York",2296,1378,4,660,188,315,1981
BB041283,36081098100,"Census Tract 981, Queens County, New York",2296,1378,4,660,188,315,1981
A1101669,36081098100,"Census Tract 981, Queens County, New York",2296,1378,4,660,188,315,1981
00925809,36081094500,"Census Tract 945, Queens County, New York",3939,2558,43,699,579,1142,2797
A0701594,36047123700,"Census Tract 1237, Kings County, New York",6370,5207,223,32,816,1042,5328
BB081206,36047123700,"Census Tract 1237, Kings County, New York",6370,5207,223,32,816,1042,5328
A0509129,36047123700,"Census Tract 1237, Kings County, New York",6370,5207,223,32,816,1042,5328
BB081208,36047123700,"Census Tract 1237, Kings County, New York",6370,5207,223,32,816,1042,5328
A9903219,36081112300,"Census Tract 1123, Queens County, New York",2319,978,26,1061,216,516,1803
00926325,36081109900,"Census Tract 1099, Queens County, New York",3994,2301,130,1241,142,1039,2955
00926234,36081114100,"Census Tract 1141, Queens County, New York",2176,1424,28,613,72,162,2014
01904173,36047080800,"Census Tract 808, Kings County, New York",1210,103,703,190,214,228,982
BB041309,36081029500,"Census Tract 295, Queens County, New York",3863,1822,172,1503,260,875,2988
00925853,36081029700,"Census Tract 297, Queens County, New York",2028,1286,72,486,70,505,1523
K9304081,36081033402,"Census Tract 334.02, Queens County, New York",12877,239,12072,98,404,1555,11322
BB940470,36081033402,"Census Tract 334.02, Queens County, New York",12877,239,12072,98,404,1555,11322
00937891,36081030902,"Census Tract 309.02, Queens County, New York",8345,3117,43,3933,1082,2390,5955
A9104961,36081033000,"Census Tract 330, Queens County, New York",7041,108,6040,243,623,841,6200
BB021440,36081039800,"Census Tract 398, Queens County, New York",1976,40,1903,0,0,40,1936
BB121726,36081039400,"Census Tract 394, Queens County, New York",2954,69,2679,0,40,180,2774
00924882,36081041500,"Census Tract 415, Queens County, New York",3582,2056,100,638,677,2399,1183
BB963938,36081044602,"Census Tract 446.02, Queens County, New York",5008,484,1582,1649,1016,1484,3524
A9104866,36081045400,"Census Tract 454, Queens County, New York",4392,379,465,3032,167,263,4129
A0701578,36081045400,"Census Tract 454, Queens County, New York",4392,379,465,3032,167,263,4129
BB912059,36081046700,"Census Tract 467, Queens County, New York",7026,4151,129,2138,511,4596,2430
BB081378,36081044800,"Census Tract 448, Queens County, New York",2625,200,352,1388,388,558,2067
00942041,36081047200,"Census Tract 472, Queens County, New York",3767,1004,1067,1361,258,480,3287
BB121759,36081045800,"Census Tract 458, Queens County, New York",2074,245,224,1254,171,269,1805
00925296,36081046600,"Census Tract 466, Queens County, New York",3494,622,1092,1449,260,563,2931
00925241,36081046600,"Census Tract 466, Queens County, New York",3494,622,1092,1449,260,563,2931
A0902283,36081043702,"Census Tract 437.02, Queens County, New York",5802,2795,973,1100,861,3572,2230
A9903217,36081036500,"Census Tract 365, Queens County, New York",4191,1051,591,136,2408,3453,738
A9105018,36081036500,"Census Tract 365, Queens County, New York",4191,1051,591,136,2408,3453,738
00940703,36081035800,"Census Tract 358, Queens County, New York",4447,6,4260,0,111,178,4269
BB964072,36081037300,"Census Tract 373, Queens County, New York",2464,634,592,207,1000,1558,906
A0107611,36081007700,"Census Tract 77, Queens County, New York",1413,878,41,352,51,283,1130
A0107740,36081044601,"Census Tract 446.01, Queens County, New York",3298,1020,982,629,580,1649,1649
BB041277,36081011500,"Census Tract 115, Queens County, New York",2389,1619,68,407,185,474,1915
00941161,36081011300,"Census Tract 113, Queens County, New York",4193,2899,48,789,366,1083,3110
00926347,36081011300,"Census Tract 113, Queens County, New York",4193,2899,48,789,366,1083,3110
00925503,36081011200,"Census Tract 112, Queens County, New York",2313,541,96,1189,374,536,1777
00941434,36081006300,"Census Tract 63, Queens County, New York",5212,3879,276,675,195,1513,3699
00925729,36081010200,"Census Tract 102, Queens County, New York",3097,378,490,573,1458,934,2163
00926336,36081010300,"Census Tract 103, Queens County, New York",3833,2736,79,632,229,611,3222
A9903263,36081012400,"Census Tract 124, Queens County, New York",2966,969,211,927,526,1188,1778
A0971574,36081012400,"Census Tract 124, Queens County, New York",2966,969,211,927,526,1188,1778
00938578,36081014000,"Census Tract 140, Queens County, New York",3493,2299,79,714,391,869,2624
BB912051,36081013400,"Census Tract 134, Queens County, New York",5571,3457,426,938,571,1263,4308
BB041276,36081014500,"Census Tract 145, Queens County, New York",2111,1564,140,299,95,359,1752
00925354,36081014700,"Census Tract 147, Queens County, New York",3043,2502,88,201,137,674,2369
00925762,36081017000,"Census Tract 170, Queens County, New York",2472,142,949,543,551,250,2222
00925387,36081018900,"Census Tract 189, Queens County, New York",3409,1944,267,735,284,1645,1764
00941445,36081023000,"Census Tract 230, Queens County, New York",2263,863,53,751,574,1002,1261
00936672,36081077906,"Census Tract 779.06, Queens County, New York",3153,1781,171,855,214,524,2629
A9300626,36081077906,"Census Tract 779.06, Queens County, New York",3153,1781,171,855,214,524,2629
A9104867,36081021200,"Census Tract 212, Queens County, New York",2270,490,201,505,905,1201,1069
A9300691,36081021600,"Census Tract 216, Queens County, New York",4289,1826,643,611,885,1421,2868
A0107565,36081090700,"Census Tract 907, Queens County, New York",1227,683,0,395,85,239,988
BB121683,36081090700,"Census Tract 907, Queens County, New York",1227,683,0,395,85,239,988
00935872,36081092800,"Census Tract 928, Queens County, New York",3497,3479,7,0,0,48,3449
00925525,36081049200,"Census Tract 492, Queens County, New York",4453,743,2353,842,214,699,3754
A1101730,36081059800,"Census Tract 598, Queens County, New York",1788,83,1561,123,8,158,1630
A9104970,36081059300,"Census Tract 593, Queens County, New York",3947,3390,138,230,117,999,2948
00924951,36081049900,"Census Tract 499, Queens County, New York",5241,1384,2,3552,239,971,4270
00925412,36081052100,"Census Tract 521, Queens County, New York",1470,1117,73,69,98,242,1228
A9300689,36081051000,"Census Tract 510, Queens County, New York",1785,38,1353,261,107,124,1661
A9300668,36081081800,"Census Tract 818, Queens County, New York",4504,509,1663,930,990,1061,3443
A9503028,36081052800,"Census Tract 528, Queens County, New York",1427,11,1348,59,4,86,1341
A9903229,36081084500,"Census Tract 845, Queens County, New York",4807,462,538,3167,390,371,4436
00925128,36081062900,"Census Tract 629, Queens County, New York",3048,2597,56,126,204,689,2359
00938465,36081062900,"Census Tract 629, Queens County, New York",3048,2597,56,126,204,689,2359
00925751,36081084000,"Census Tract 840, Queens County, New York",6208,1032,936,1993,1469,1208,5000
00925547,36081054000,"Census Tract 540, Queens County, New York",4391,342,3269,258,437,536,3855
BB041319,36081054000,"Census Tract 540, Queens County, New York",4391,342,3269,258,437,536,3855
00925117,36081063500,"Census Tract 635, Queens County, New York",2653,2588,41,5,7,857,1796
00944253,36081063900,"Census Tract 639, Queens County, New York",2549,1752,61,371,215,529,2020
00925707,36081063800,"Census Tract 638, Queens County, New York",3929,275,3343,202,20,233,3696
A1101713,36081063800,"Census Tract 638, Queens County, New York",3929,275,3343,202,20,233,3696
BB101113,36081086300,"Census Tract 863, Queens County, New York",6903,722,152,5225,724,1308,5595
00943996,36081064600,"Census Tract 646, Queens County, New York",3026,22,2839,0,122,150,2876
00925172,36081089200,"Census Tract 892, Queens County, New York",8272,7989,0,87,143,465,7807
BB121736,36081088400,"Census Tract 884, Queens County, New York",7500,6889,86,120,202,954,6546
00939924,36081065600,"Census Tract 656, Queens County, New York",5014,409,4340,182,52,283,4731
BB964143,36081065600,"Census Tract 656, Queens County, New York",5014,409,4340,182,52,283,4731
A9105034,36081048900,"Census Tract 489, Queens County, New York",1599,446,8,858,274,557,1042
BB121733,36081068200,"Census Tract 682, Queens County, New York",1259,0,1203,29,0,45,1214
00925434,36081066501,"Census Tract 665.01, Queens County, New York",3321,3262,1,21,14,154,3167
A0502483,36081068700,"Census Tract 687, Queens County, New York",4619,2171,42,2100,116,864,3755
00938454,36081056800,"Census Tract 568, Queens County, New York",4880,760,3433,195,267,1021,3859
A9104709,36081056800,"Census Tract 568, Queens County, New York",4880,760,3433,195,267,1021,3859
00935362,36081056800,"Census Tract 568, Queens County, New York",4880,760,3433,195,267,1021,3859
BB121753,36081056800,"Census Tract 568, Queens County, New York",4880,760,3433,195,267,1021,3859
A1101700,36081056800,"Census Tract 568, Queens County, New York",4880,760,3433,195,267,1021,3859
00925037,36081145101,"Census Tract 1451.01, Queens County, New York",1647,1059,3,452,0,115,1532
00936446,36081145101,"Census Tract 1451.01, Queens County, New York",1647,1059,3,452,0,115,1532
02047954,36081140902,"Census Tract 1409.02, Queens County, New York",3049,1053,128,1845,23,243,2806
00924893,36081150701,"Census Tract 1507.01, Queens County, New York",3033,2191,2,797,10,223,2810
00940237,36081071100,"Census Tract 711, Queens County, New York",5604,3631,52,1455,194,645,4959
A9104815,36081071100,"Census Tract 711, Queens County, New York",5604,3631,52,1455,194,645,4959
00941048,36081069702,"Census Tract 697.02, Queens County, New York",3499,2061,33,1284,68,193,3306
00925081,36081072900,"Census Tract 729, Queens County, New York",1155,678,34,419,0,92,1063
01657916,36081076902,"Census Tract 769.02, Queens County, New York",1506,888,26,486,64,146,1360
00939061,36081076902,"Census Tract 769.02, Queens County, New York",1506,888,26,486,64,146,1360
00925092,36081073700,"Census Tract 737, Queens County, New York",1753,1336,1,268,65,162,1591
00935781,36081077500,"Census Tract 775, Queens County, New York",1985,1698,28,98,103,298,1687
A9503007,36081077902,"Census Tract 779.02, Queens County, New York",5223,4570,200,380,57,226,4997
00924871,36081037900,"Census Tract 379, Queens County, New York",7116,2358,447,286,3574,6635,481
00925456,36081157902,"Census Tract 1579.02, Queens County, New York",3902,1653,174,1725,134,463,3439
00943158,36081157901,"Census Tract 1579.01, Queens County, New York",4978,2030,84,2514,44,373,4605
00926267,36081161700,"Census Tract 1617, Queens County, New York",4623,3146,12,1013,314,1086,3537
BB964055,36081155102,"Census Tract 1551.02, Queens County, New York",7629,4433,785,1765,251,738,6891
00925274,36081126500,"Census Tract 1265, Queens County, New York",1578,751,148,495,72,366,1212
A9903289,36081125700,"Census Tract 1257, Queens County, New York",3116,776,415,1493,108,268,2848
00942438,36081124100,"Census Tract 1241, Queens County, New York",3400,1502,271,1536,41,168,3232
00925106,36081134700,"Census Tract 1347, Queens County, New York",9563,2867,643,4803,761,1610,7953
A9903264,36081101002,"Census Tract 1010.02, Queens County, New York",4549,3825,560,11,141,486,4063
00937304,36081101002,"Census Tract 1010.02, Queens County, New York",4549,3825,560,11,141,486,4063
00935861,36081101002,"Census Tract 1010.02, Queens County, New York",4549,3825,560,11,141,486,4063
00925671,36081094201,"Census Tract 942.01, Queens County, New York",3765,1824,1444,220,176,1184,2581
00925682,36081094203,"Census Tract 942.03, Queens County, New York",5396,3242,1405,241,310,826,4570
00925015,36081117100,"Census Tract 1171, Queens County, New York",2901,930,45,1379,457,754,2147
A1101628,36081117100,"Census Tract 1171, Queens County, New York",2901,930,45,1379,457,754,2147
00939196,36081116700,"Census Tract 1167, Queens County, New York",1905,359,14,1072,434,585,1320
00922965,36085015601,"Census Tract 156.01, Richmond County, New York",6245,5625,4,298,141,812,5433
00941456,36085015601,"Census Tract 156.01, Richmond County, New York",6245,5625,4,298,141,812,5433
A9105062,36085014606,"Census Tract 146.06, Richmond County, New York",7545,6980,84,399,45,594,6951
00922546,36085016901,"Census Tract 169.01, Richmond County, New York",3145,2589,159,249,89,702,2443
00920196,36085002100,"Census Tract 21, Richmond County, New York",3921,1862,1094,190,598,1670,2251
01607454,36085002002,"Census Tract 20.02, Richmond County, New York",3233,2606,11,553,5,167,3066
A0502554,36085002002,"Census Tract 20.02, Richmond County, New York",3233,2606,11,553,5,167,3066
00920301,36085002002,"Census Tract 20.02, Richmond County, New York",3233,2606,11,553,5,167,3066
A1101696,36085002002,"Census Tract 20.02, Richmond County, New York",3233,2606,11,553,5,167,3066
00920232,36085003300,"Census Tract 33, Richmond County, New York",3631,2048,764,469,273,798,2833
00920265,36085003300,"Census Tract 33, Richmond County, New York",3631,2048,764,469,273,798,2833
00920221,36085003300,"Census Tract 33, Richmond County, New York",3631,2048,764,469,273,798,2833
00935963,36061026900,"Census Tract 269, New York County, New York",9197,2330,686,128,5443,8206,991
00919544,36061024301,"Census Tract 243.01, New York County, New York",4246,1181,1989,0,904,2003,2243
A9105045,36061026300,"Census Tract 263, New York County, New York",9388,2539,847,99,5375,8025,1363
00944093,36061030300,"Census Tract 303, New York County, New York",4397,2062,312,53,1625,2763,1634
00920141,36061030300,"Census Tract 303, New York County, New York",4397,2062,312,53,1625,2763,1634
00939684,36061016300,"Census Tract 163, New York County, New York",7276,6062,118,901,87,291,6985
00921928,36061029900,"Census Tract 299, New York County, New York",4320,1025,914,0,2080,3437,883
02047364,36061029900,"Census Tract 299, New York County, New York",4320,1025,914,0,2080,3437,883
00921848,36061028700,"Census Tract 287, New York County, New York",4268,1986,216,100,1619,2703,1565
00920811,36061010800,"Census Tract 108, New York County, New York",8731,7289,177,1070,92,567,8164
A0107707,36085007500,"Census Tract 75, Richmond County, New York",4715,2843,1091,227,469,2093,2622
A9104729,36085007500,"Census Tract 75, Richmond County, New York",4715,2843,1091,227,469,2093,2622
00920378,36085008100,"Census Tract 81, Richmond County, New York",4023,1813,1498,211,91,876,3147
A0701697,36085007400,"Census Tract 74, Richmond County, New York",4725,3669,27,723,296,807,3918
00920185,36085006400,"Census Tract 64, Richmond County, New York",3116,2065,706,267,0,540,2576
A0740096,36085009700,"Census Tract 97, Richmond County, New York",4055,1924,1730,16,217,1130,2925
A9104665,36061014700,"Census Tract 147, New York County, New York",2804,1895,57,683,67,170,2634
02048029,36085023900,"Census Tract 239, Richmond County, New York",3386,1603,280,161,1231,2343,1043
A0502612,36085018702,"Census Tract 187.02, Richmond County, New York",7316,4411,451,2265,180,1256,6060
A1140017,36085018702,"Census Tract 187.02, Richmond County, New York",7316,4411,451,2265,180,1256,6060
00920334,36085020803,"Census Tract 208.03, Richmond County, New York",6317,6038,44,118,0,581,5736
00936413,36085020803,"Census Tract 208.03, Richmond County, New York",6317,6038,44,118,0,581,5736
X0935282,36061015002,"Census Tract 150.02, New York County, New York",5461,5207,28,108,37,494,4967
A9702470,36061015002,"Census Tract 150.02, New York County, New York",5461,5207,28,108,37,494,4967
00939629,36061015002,"Census Tract 150.02, New York County, New York",5461,5207,28,108,37,494,4967
A0902294,36061015200,"Census Tract 152, New York County, New York",7162,4631,1067,767,474,1883,5279
00941219,36085013400,"Census Tract 134, Richmond County, New York",3726,3458,0,147,121,590,3136
00920254,36085013302,"Census Tract 133.02, Richmond County, New York",3672,1057,1729,333,407,1208,2464
00920287,36085024700,"Census Tract 247, Richmond County, New York",2767,1355,955,158,189,837,1930
00922852,36085012200,"Census Tract 122, Richmond County, New York",3591,3391,42,136,13,244,3347
A9104809,36061020800,"Census Tract 208, New York County, New York",5443,1226,3046,564,191,726,4717
00940565,36061008300,"Census Tract 83, New York County, New York",4014,2465,385,431,306,762,3252
00940022,36061008300,"Census Tract 83, New York County, New York",4014,2465,385,431,306,762,3252
00919227,36061003602,"Census Tract 36.02, New York County, New York",2998,1877,374,426,39,372,2626
A1101740,36061003602,"Census Tract 36.02, New York County, New York",2998,1877,374,426,39,372,2626
A0701608,36061001502,"Census Tract 15.02, New York County, New York",7315,4888,332,1700,160,479,6836
00922025,36085013201,"Census Tract 132.01, Richmond County, New York",1510,1441,0,62,7,105,1405
00922604,36085013201,"Census Tract 132.01, Richmond County, New York",1510,1441,0,62,7,105,1405
A0701654,36085018902,"Census Tract 189.02, Richmond County, New York",4959,3207,165,1221,204,468,4491
00920276,36085010500,"Census Tract 105, Richmond County, New York",4986,3116,883,346,496,1624,3362
00939618,36061016002,"Census Tract 160.02, New York County, New York",3276,2422,129,403,211,465,2811
BB121826,36061016002,"Census Tract 160.02, New York County, New York",3276,2422,129,403,211,465,2811
A9303881,36061015300,"Census Tract 153, New York County, New York",9025,7908,224,729,0,853,8172
00935216,36061004800,"Census Tract 48, New York County, New York",7551,5293,437,1214,363,584,6967
A0502504,36061013800,"Census Tract 138, New York County, New York",12771,11278,173,897,16,924,11847
A1101726,36061013800,"Census Tract 138, New York County, New York",12771,11278,173,897,16,924,11847
00922477,36061018000,"Census Tract 180, New York County, New York",7717,1805,2435,565,2630,4407,3310
00921859,36061018000,"Census Tract 180, New York County, New York",7717,1805,2435,565,2630,4407,3310
A0902362,36061007400,"Census Tract 74, New York County, New York",3754,2924,93,530,78,375,3379
A1101620,36061007400,"Census Tract 74, New York County, New York",3754,2924,93,530,78,375,3379
A0502465,36061003200,"Census Tract 32, New York County, New York",7802,6105,186,1133,247,623,7179
A9502938,36061003200,"Census Tract 32, New York County, New York",7802,6105,186,1133,247,623,7179
00920017,36061007700,"Census Tract 77, New York County, New York",5515,4799,86,354,14,368,5147
A9104914,36061028100,"Census Tract 281, New York County, New York",2998,2586,168,97,49,374,2624
A0701603,36061017200,"Census Tract 172, New York County, New York",5660,1948,1496,317,1815,3501,2159
A1101685,36061017200,"Census Tract 172, New York County, New York",5660,1948,1496,317,1815,3501,2159
A0502492,36061009500,"Census Tract 95, New York County, New York",3334,2419,133,613,0,158,3176
00920083,36061003400,"Census Tract 34, New York County, New York",6673,5193,136,824,334,1245,5428
02047353,36061017900,"Census Tract 179, New York County, New York",9333,7285,689,477,61,1520,7813
A0302291,36061020500,"Census Tract 205, New York County, New York",5191,3880,341,810,18,368,4823
00939141,36061020500,"Census Tract 205, New York County, New York",5191,3880,341,810,18,368,4823
00920028,36061027300,"Census Tract 273, New York County, New York",7020,5103,508,241,798,2037,4983
A0740102,36061014200,"Census Tract 142, New York County, New York",4288,3944,14,94,39,318,3970
A9903261,36061014200,"Census Tract 142, New York County, New York",4288,3944,14,94,39,318,3970
00920061,36061014200,"Census Tract 142, New York County, New York",4288,3944,14,94,39,318,3970
01607319,36061014200,"Census Tract 142, New York County, New York",4288,3944,14,94,39,318,3970
K9303936,36061000800,"Census Tract 8, New York County, New York",9333,846,88,7814,392,262,9071
00919453,36061000800,"Census Tract 8, New York County, New York",9333,846,88,7814,392,262,9071
02047207,36061023801,"Census Tract 238.01, New York County, New York",9667,5150,1219,2443,347,1578,8089
A0902348,36061022000,"Census Tract 220, New York County, New York",5577,968,3302,272,877,1084,4493
A0502613,36061027100,"Census Tract 271, New York County, New York",9557,4835,578,343,3232,6339,3218
00919883,36061027100,"Census Tract 271, New York County, New York",9557,4835,578,343,3232,6339,3218
BB121817,36061027100,"Census Tract 271, New York County, New York",9557,4835,578,343,3232,6339,3218
00936355,36061001200,"Census Tract 12, New York County, New York",3552,1893,155,838,587,1019,2533
00939833,36061013600,"Census Tract 136, New York County, New York",15641,13671,181,998,312,741,14900
00919566,36061013600,"Census Tract 136, New York County, New York",15641,13671,181,998,312,741,14900
00939491,36061013600,"Census Tract 136, New York County, New York",15641,13671,181,998,312,741,14900
00936027,36061000600,"Census Tract 6, New York County, New York",11354,1418,1033,6189,2462,3500,7854
A0701599,36061000900,"Census Tract 9, New York County, New York",1396,1116,32,118,84,154,1242
00919475,36005020200,"Census Tract 202, Bronx County, New York",2240,409,295,480,955,1304,936
00921462,36005006500,"Census Tract 65, Bronx County, New York",5847,767,2207,39,2801,3424,2423
BB041254,36047105804,"Census Tract 1058.04, Kings County, New York",6200,1933,3399,221,461,1380,4820
00924656,36047069602,"Census Tract 696.02, Kings County, New York",6339,3957,1527,349,368,960,5379
K9304063,36047105801,"Census Tract 1058.01, Kings County, New York",6654,2272,3531,135,558,1424,5230
00921393,36005025000,"Census Tract 250, Bronx County, New York",2817,1752,32,309,591,793,2024
00920902,36005025500,"Census Tract 255, Bronx County, New York",5764,530,1423,50,3391,4302,1462
00922138,36005026601,"Census Tract 266.01, Bronx County, New York",2911,1795,92,85,792,1083,1828
00921564,36005026602,"Census Tract 266.02, Bronx County, New York",5488,3105,343,89,1613,2593,2895
00939276,36005030000,"Census Tract 300, Bronx County, New York",5751,2850,230,660,1679,2389,3362
01607352,36005028900,"Census Tract 289, Bronx County, New York",4027,1682,246,231,1583,2577,1450
00920946,36005028300,"Census Tract 283, Bronx County, New York",3390,535,957,13,1752,2408,982
00940918,36005032400,"Census Tract 324, Bronx County, New York",2798,668,805,9,1142,1695,1103
A0502542,36005032300,"Census Tract 323, Bronx County, New York",4489,3167,464,602,23,946,3543
AA001686,36005030701,"Census Tract 307.01, Bronx County, New York",5283,4450,230,136,436,684,4599
00921597,36005040600,"Census Tract 406, Bronx County, New York",3377,281,2564,48,360,624,2753
00921586,36005039902,"Census Tract 399.02, Bronx County, New York",4786,769,1051,88,2567,3515,1271
00923062,36005039400,"Census Tract 394, Bronx County, New York",4702,486,3078,40,1051,1530,3172
00921644,36005039100,"Census Tract 391, Bronx County, New York",7201,2065,941,25,3856,5053,2148
00921575,36005038700,"Census Tract 387, Bronx County, New York",3023,905,747,54,1147,1756,1267
00920935,36005038100,"Census Tract 381, Bronx County, New York",6145,1007,1895,91,2929,4662,1483
A9104949,36005038600,"Census Tract 386, Bronx County, New York",7448,278,5771,245,1059,1308,6140
A1101659,36005038600,"Census Tract 386, Bronx County, New York",7448,278,5771,245,1059,1308,6140
00920855,36005040702,"Census Tract 407.02, Bronx County, New York",6839,1368,1218,219,3849,4667,2172
00925343,36081012100,"Census Tract 121, Queens County, New York",2090,1702,26,240,106,321,1769
00925649,36081055100,"Census Tract 551, Queens County, New York",5135,4053,70,340,498,2600,2535
BB061148,36081129102,"Census Tract 1291.02, Queens County, New York",3367,2235,6,932,32,210,3157
A1101695,36081120100,"Census Tract 1201, Queens County, New York",1711,290,10,1355,28,133,1578
A9903249,36081059600,"Census Tract 596, Queens County, New York",1523,14,1502,0,0,8,1515
00925569,36081067900,"Census Tract 679, Queens County, New York",3642,3072,137,294,83,1175,2467
00943409,36081140300,"Census Tract 1403, Queens County, New York",2515,916,14,1407,156,491,2024
A9105003,36081111300,"Census Tract 1113, Queens County, New York",2612,1229,6,971,74,301,2311
BB061153,36081059000,"Census Tract 590, Queens County, New York",1489,30,1343,14,72,99,1390
00925059,36081085300,"Census Tract 853, Queens County, New York",4624,324,133,4092,18,381,4243
00942948,36081085300,"Census Tract 853, Queens County, New York",4624,324,133,4092,18,381,4243
BB081373,36081063200,"Census Tract 632, Queens County, New York",2228,19,2070,76,30,30,2198
BB964126,36081063200,"Census Tract 632, Queens County, New York",2228,19,2070,76,30,30,2198
BB940557,36081053200,"Census Tract 532, Queens County, New York",1801,58,1582,21,0,87,1714
A0107548,36081051200,"Census Tract 512, Queens County, New York",3068,103,2209,50,379,334,2734
00925842,36081001600,"Census Tract 16, Queens County, New York",3193,1768,201,386,531,2147,1046
A0108071,36081077904,"Census Tract 779.04, Queens County, New York",6311,4086,228,1594,253,764,5547
BB121674,36081001900,"Census Tract 19, Queens County, New York",1343,763,30,341,193,291,1052
00925208,36081028300,"Census Tract 283, Queens County, New York",6619,4123,270,1125,952,3799,2820
00925897,36081092500,"Census Tract 925, Queens County, New York",3739,1435,108,928,1067,1786,1953
00924984,36081124700,"Census Tract 1247, Queens County, New York",3326,2361,58,903,4,180,3146
AA001442,36081101001,"Census Tract 1010.01, Queens County, New York",10118,4663,3402,510,1316,3740,6378
BB121767,36081023200,"Census Tract 232, Queens County, New York",5670,1445,641,2168,1027,1413,4257
00925321,36081005900,"Census Tract 59, Queens County, New York",3754,2905,60,352,289,1188,2566
A0107872,36081074100,"Census Tract 741, Queens County, New York",3008,2156,10,748,11,324,2684
BB000826,36081013000,"Census Tract 130, Queens County, New York",1510,795,140,308,232,420,1090
A0302300,36081013000,"Census Tract 130, Queens County, New York",1510,795,140,308,232,420,1090
00925536,36081056000,"Census Tract 560, Queens County, New York",1431,402,271,518,148,245,1186
A9104937,36081037700,"Census Tract 377, Queens County, New York",3552,1128,594,141,1632,2935,617
00926507,36081068300,"Census Tract 683, Queens County, New York",4589,2235,189,1802,238,2168,2421
A9303704,36081043200,"Census Tract 432, Queens County, New York",1429,62,1312,0,25,136,1293
A0902318,36061024200,"Census Tract 242, New York County, New York",3709,649,1875,168,825,1864,1845
A9300620,36047000502,"Census Tract 5.02, Kings County, New York",2632,2185,95,190,63,193,2439
A0902270,36047000502,"Census Tract 5.02, Kings County, New York",2632,2185,95,190,63,193,2439
BB041226,36047050804,"Census Tract 508.04, Kings County, New York",5911,830,3335,160,1428,1827,4084
A0302235,36047035602,"Census Tract 356.02, Kings County, New York",4580,4525,54,0,1,65,4515
BB101107,36047067400,"Census Tract 674, Kings County, New York",1967,586,1135,135,28,230,1737
00938181,36047069800,"Census Tract 698, Kings County, New York",1373,1181,0,92,86,152,1221
A1101745,36047022400,"Census Tract 224, Kings County, New York",6057,4325,100,568,1032,1424,4633
A9105144,36047022400,"Census Tract 224, Kings County, New York",6057,4325,100,568,1032,1424,4633
BB041180,36047022600,"Census Tract 226, Kings County, New York",2423,708,25,495,1195,1321,1102
BB101073,36047022800,"Census Tract 228, Kings County, New York",3574,2016,59,751,716,801,2773
00943679,36047022700,"Census Tract 227, Kings County, New York",3449,723,2237,184,223,456,2993
A0508009,36047022700,"Census Tract 227, Kings County, New York",3449,723,2237,184,223,456,2993
00942245,36047023600,"Census Tract 236, Kings County, New York",5470,5350,8,102,0,158,5312
A0502614,36047024400,"Census Tract 244, Kings County, New York",3523,2577,13,577,356,637,2886
A0107700,36047024000,"Census Tract 240, Kings County, New York",4421,4169,46,40,97,190,4231
A0701653,36047024000,"Census Tract 240, Kings County, New York",4421,4169,46,40,97,190,4231
A1101624,36047024000,"Census Tract 240, Kings County, New York",4421,4169,46,40,97,190,4231
A9702356,36047024800,"Census Tract 248, Kings County, New York",2880,1680,41,859,275,641,2239
00924678,36047024600,"Census Tract 246, Kings County, New York",3552,2194,30,1172,126,204,3348
A9300645,36047025200,"Census Tract 252, Kings County, New York",5307,3174,67,1900,111,983,4324
BB101060,36047023000,"Census Tract 230, Kings County, New York",4213,3328,60,217,545,837,3376
00942857,36047023000,"Census Tract 230, Kings County, New York",4213,3328,60,217,545,837,3376
A9105071,36047024200,"Census Tract 242, Kings County, New York",2936,2565,18,318,26,138,2798
AA001675,36047024200,"Census Tract 242, Kings County, New York",2936,2565,18,318,26,138,2798
BB121571,36047024200,"Census Tract 242, Kings County, New York",2936,2565,18,318,26,138,2798
A0107510,36047073400,"Census Tract 734, Kings County, New York",2416,104,2177,0,65,115,2301
00924532,36047075600,"Census Tract 756, Kings County, New York",2051,1714,109,204,14,66,1985
A0509136,36047035500,"Census Tract 355, Kings County, New York",4952,628,3899,0,425,532,4420
BB981072,36047034900,"Census Tract 349, Kings County, New York",5737,313,4651,188,522,708,5029
BB081253,36047034900,"Census Tract 349, Kings County, New York",5737,313,4651,188,522,708,5029
BB121521,36047034900,"Census Tract 349, Kings County, New York",5737,313,4651,188,522,708,5029
A0107860,36047074800,"Census Tract 748, Kings County, New York",1787,1357,357,0,73,100,1687
00942915,36047076000,"Census Tract 760, Kings County, New York",2853,2544,26,188,86,144,2709
A1101711,36047096400,"Census Tract 964, Kings County, New York",2569,99,1823,38,517,598,1971
00936275,36047099400,"Census Tract 994, Kings County, New York",1910,81,1646,0,155,193,1717
BB041144,36047076600,"Census Tract 766, Kings County, New York",2437,214,1957,0,238,290,2147
00924598,36047095800,"Census Tract 958, Kings County, New York",3785,186,2835,194,530,632,3153
A9903303,36047074600,"Census Tract 746, Kings County, New York",2207,1522,524,121,6,196,2011
A0902361,36047074600,"Census Tract 746, Kings County, New York",2207,1522,524,121,6,196,2011
A0740097,36085018100,"Census Tract 181, Richmond County, New York",3049,2806,27,189,7,386,2663
00935577,36047027000,"Census Tract 270, Kings County, New York",2338,1612,19,529,178,203,2135
BB081260,36047029000,"Census Tract 290, Kings County, New York",4215,2856,15,851,390,534,3681
BB940407,36047027200,"Census Tract 272, Kings County, New York",3654,2053,0,1058,484,618,3036
BB081219,36047028700,"Census Tract 287, Kings County, New York",3011,650,1857,179,315,585,2426
BB963756,36047029800,"Census Tract 298, Kings County, New York",3834,2638,2,815,379,793,3041
00926187,36047029800,"Census Tract 298, Kings County, New York",3834,2638,2,815,379,793,3041
BB061130,36047038800,"Census Tract 388, Kings County, New York",4122,3507,39,245,97,293,3829
00936162,36047037000,"Census Tract 370, Kings County, New York",4085,2763,9,1196,21,229,3856
A0990087,36047036400,"Census Tract 364, Kings County, New York",2126,1305,41,630,146,308,1818
K9304032,36047077200,"Census Tract 772, Kings County, New York",3223,1499,1506,30,121,239,2984
BB963538,36047077200,"Census Tract 772, Kings County, New York",3223,1499,1506,30,121,239,2984
A1101707,36047036700,"Census Tract 367, Kings County, New York",1285,136,733,33,333,488,797
A0107582,36047007700,"Census Tract 77, Kings County, New York",4352,3273,104,398,324,626,3726
A0701680,36047007700,"Census Tract 77, Kings County, New York",4352,3273,104,398,324,626,3726
A0302209,36047031400,"Census Tract 314, Kings County, New York",4201,3221,97,850,33,308,3893
BB121531,36047031400,"Census Tract 314, Kings County, New York",4201,3221,97,850,33,308,3893
BB121533,36047031400,"Census Tract 314, Kings County, New York",4201,3221,97,850,33,308,3893
00943624,36047034100,"Census Tract 341, Kings County, New York",2643,268,2016,0,219,222,2421
BB061072,36047033500,"Census Tract 335, Kings County, New York",3012,1890,843,143,71,297,2715
02046178,36047033500,"Census Tract 335, Kings County, New York",3012,1890,843,143,71,297,2715
BB963607,36047033900,"Census Tract 339, Kings County, New York",4365,743,3256,83,189,333,4032
A1101634,36047033900,"Census Tract 339, Kings County, New York",4365,743,3256,83,189,333,4032
BB121609,36047033100,"Census Tract 331, Kings County, New York",4350,2739,1418,0,166,295,4055
BB061133,36047031900,"Census Tract 319, Kings County, New York",3652,569,3065,9,0,254,3398
00936253,36047031900,"Census Tract 319, Kings County, New York",3652,569,3065,9,0,254,3398
A0701596,36047040000,"Census Tract 400, Kings County, New York",3623,1571,8,1579,263,406,3217
A1101676,36047041900,"Census Tract 419, Kings County, New York",4048,1995,1228,45,468,2660,1388
BB041209,36047041600,"Census Tract 416, Kings County, New York",2736,2232,44,162,245,339,2397
A9903137,36047041600,"Census Tract 416, Kings County, New York",2736,2232,44,162,245,339,2397
BB121621,36047041600,"Census Tract 416, Kings County, New York",2736,2232,44,162,245,339,2397
00924215,36047042300,"Census Tract 423, Kings County, New York",4851,2949,834,243,662,3567,1284
A0302188,36047041800,"Census Tract 418, Kings County, New York",2024,1882,60,52,25,232,1792
00935668,36047041800,"Census Tract 418, Kings County, New York",2024,1882,60,52,25,232,1792
AA000953,36047041800,"Census Tract 418, Kings County, New York",2024,1882,60,52,25,232,1792
A0902296,36047042800,"Census Tract 428, Kings County, New York",4036,2667,30,1155,176,390,3646
BB121449,36047043000,"Census Tract 430, Kings County, New York",3080,1676,0,1257,147,412,2668
A0790120,36047019400,"Census Tract 194, Kings County, New York",3653,1153,65,2250,178,486,3167
00926427,36047117602,"Census Tract 1176.02, Kings County, New York",2911,1086,682,49,952,2179,732
A9104784,36047019500,"Census Tract 195, Kings County, New York",3998,1854,1442,316,270,723,3275
A9105125,36047058200,"Census Tract 582, Kings County, New York",2997,1759,0,962,175,317,2680
A0971530,36047032100,"Census Tract 321, Kings County, New York",5898,1090,4441,124,215,838,5060
BB000817,36047059600,"Census Tract 596, Kings County, New York",2416,2274,38,80,24,85,2331
00924634,36047044100,"Census Tract 441, Kings County, New York",6547,2356,809,606,2493,5297,1250
A0302265,36047045200,"Census Tract 452, Kings County, New York",2672,2503,0,43,67,111,2561
A0902444,36047045200,"Census Tract 452, Kings County, New York",2672,2503,0,43,67,111,2561
00926449,36047044600,"Census Tract 446, Kings County, New York",1933,1185,13,614,91,201,1732
A0302336,36047044400,"Census Tract 444, Kings County, New York",3237,2793,12,146,227,271,2966
A0701633,36047044400,"Census Tract 444, Kings County, New York",3237,2793,12,146,227,271,2966
00935715,36047044000,"Census Tract 440, Kings County, New York",2637,2362,2,36,137,237,2400
BB041224,36047079400,"Census Tract 794, Kings County, New York",1820,6,1654,23,124,153,1667
BB963279,36047079400,"Census Tract 794, Kings County, New York",1820,6,1654,23,124,153,1667
00924248,36047080400,"Census Tract 804, Kings County, New York",3169,258,2459,263,167,255,2914
BB121611,36047080400,"Census Tract 804, Kings County, New York",3169,258,2459,263,167,255,2914
BB041272,36047080200,"Census Tract 802, Kings County, New York",5115,385,4079,88,529,735,4380
A0971589,36047080200,"Census Tract 802, Kings County, New York",5115,385,4079,88,529,735,4380
A0902322,36047080200,"Census Tract 802, Kings County, New York",5115,385,4079,88,529,735,4380
01904049,36047026100,"Census Tract 261, Kings County, New York",5062,1248,3440,74,255,819,4243
00936264,36047099600,"Census Tract 996, Kings County, New York",3755,149,3504,81,14,71,3684
AA001663,36047042000,"Census Tract 420, Kings County, New York",1979,1723,9,124,107,108,1871
A1101638,36047042000,"Census Tract 420, Kings County, New York",1979,1723,9,124,107,108,1871
BB101103,36047036300,"Census Tract 363, Kings County, New York",3977,116,3402,0,396,601,3376
A9104811,36047082200,"Census Tract 822, Kings County, New York",7326,504,6120,71,433,944,6382
00926245,36047083200,"Census Tract 832, Kings County, New York",2238,163,1911,74,35,106,2132
00926143,36047048100,"Census Tract 481, Kings County, New York",2779,2101,106,226,237,872,1907
00924292,36047082800,"Census Tract 828, Kings County, New York",3751,213,3227,190,105,328,3423
BB101011,36047047400,"Census Tract 474, Kings County, New York",3127,2980,0,113,0,20,3107
AA000069,36047047600,"Census Tract 476, Kings County, New York",3929,3593,59,0,253,280,3649
00942176,36047048000,"Census Tract 480, Kings County, New York",3416,2755,55,359,180,629,2787
BB081325,36047048000,"Census Tract 480, Kings County, New York",3416,2755,55,359,180,629,2787
00938691,36047047000,"Census Tract 470, Kings County, New York",2763,2688,32,31,12,45,2718
01904209,36047047000,"Census Tract 470, Kings County, New York",2763,2688,32,31,12,45,2718
A0502522,36047047800,"Census Tract 478, Kings County, New York",4690,3478,9,123,1001,1002,3688
A0701682,36047047800,"Census Tract 478, Kings County, New York",4690,3478,9,123,1001,1002,3688
A9105123,36047047800,"Census Tract 478, Kings County, New York",4690,3478,9,123,1001,1002,3688
BB101093,36047045800,"Census Tract 458, Kings County, New York",1508,1467,11,16,0,14,1494
A0302194,36047046400,"Census Tract 464, Kings County, New York",2826,2588,6,200,26,54,2772
A1101642,36047047700,"Census Tract 477, Kings County, New York",3548,2817,169,298,178,388,3160
A0902349,36047026500,"Census Tract 265, Kings County, New York",3764,440,2941,102,144,287,3477
00924816,36047010200,"Census Tract 102, Kings County, New York",5257,1020,47,3670,428,1221,4036
BB061144,36047021700,"Census Tract 217, Kings County, New York",3610,1177,1854,293,111,276,3334
A0107562,36047116800,"Census Tract 1168, Kings County, New York",1545,550,665,166,151,711,834
A0502424,36047024100,"Census Tract 241, Kings County, New York",2480,1210,847,192,214,568,1912
00935588,36047048400,"Census Tract 484, Kings County, New York",5509,4125,454,499,420,519,4990
A0502470,36047096600,"Census Tract 966, Kings County, New York",2478,259,1804,39,350,299,2179
A0507944,36047085800,"Census Tract 858, Kings County, New York",2378,70,2189,38,40,56,2322
BB963440,36047081000,"Census Tract 810, Kings County, New York",2196,114,1860,77,74,99,2097
Y0936628,36047054600,"Census Tract 546, Kings County, New York",4407,4034,81,223,59,258,4149
A0902315,36047054600,"Census Tract 546, Kings County, New York",4407,4034,81,223,59,258,4149
A9300670,36047049400,"Census Tract 494, Kings County, New York",5651,3429,477,1084,413,674,4977
00924441,36047050000,"Census Tract 500, Kings County, New York",3508,2457,317,432,70,530,2978
A0302206,36047049200,"Census Tract 492, Kings County, New York",3524,1623,658,717,493,566,2958
BB121553,36047049200,"Census Tract 492, Kings County, New York",3524,1623,658,717,493,566,2958
00943737,36047076400,"Census Tract 764, Kings County, New York",3820,1449,1717,119,404,505,3315
BB963781,36047021300,"Census Tract 213, Kings County, New York",4399,754,3488,75,36,147,4252
BB981108,36047021300,"Census Tract 213, Kings County, New York",4399,754,3488,75,36,147,4252
A9104820,36047021300,"Census Tract 213, Kings County, New York",4399,754,3488,75,36,147,4252
BB041112,36047093800,"Census Tract 938, Kings County, New York",2191,49,2130,0,0,12,2179
A0107653,36047059402,"Census Tract 594.02, Kings County, New York",4462,3446,66,908,0,163,4299
A1101747,36047059402,"Census Tract 594.02, Kings County, New York",4462,3446,66,908,0,163,4299
00924463,36047050500,"Census Tract 505, Kings County, New York",4179,1789,779,532,844,2126,2053
BB121461,36047050500,"Census Tract 505, Kings County, New York",4179,1789,779,532,844,2126,2053
BB081273,36047050600,"Census Tract 506, Kings County, New York",5630,1405,2702,254,1193,2009,3621
BB963334,36047050600,"Census Tract 506, Kings County, New York",5630,1405,2702,254,1193,2009,3621
A0902355,36047050700,"Census Tract 507, Kings County, New York",2452,1989,171,15,219,530,1922
BB963294,36047050400,"Census Tract 504, Kings County, New York",4687,2807,612,547,513,839,3848
A9702526,36047075000,"Census Tract 750, Kings County, New York",2998,2431,463,69,5,51,2947
A0502500,36047033300,"Census Tract 333, Kings County, New York",4482,2976,1264,0,133,185,4297
00924565,36047018800,"Census Tract 188, Kings County, New York",2950,1789,17,1075,24,253,2697
00941478,36047049500,"Census Tract 495, Kings County, New York",2680,2214,6,266,88,656,2024
A0107513,36047022900,"Census Tract 229, Kings County, New York",3743,1044,2183,172,143,292,3451
00943919,36047003500,"Census Tract 35, Kings County, New York",1723,542,826,208,38,117,1606
A0701709,36047003500,"Census Tract 35, Kings County, New York",1723,542,826,208,38,117,1606
A0701637,36047082400,"Census Tract 824, Kings County, New York",4004,137,3472,16,255,372,3632
A9104699,36047011800,"Census Tract 118, Kings County, New York",2131,360,124,1220,252,444,1687
02046054,36047053200,"Census Tract 532, Kings County, New York",2467,1563,210,588,50,94,2373
02046484,36047064200,"Census Tract 642, Kings County, New York",2355,2122,7,122,49,205,2150
BB121617,36047064200,"Census Tract 642, Kings County, New York",2355,2122,7,122,49,205,2150
BB041260,36047088800,"Census Tract 888, Kings County, New York",3929,73,3336,0,499,570,3359
BB121614,36047051400,"Census Tract 514, Kings County, New York",7009,816,3746,347,1743,2331,4678
AA890662,36047052600,"Census Tract 526, Kings County, New York",4672,2126,1039,646,653,1041,3631
BB963666,36047052600,"Census Tract 526, Kings County, New York",4672,2126,1039,646,653,1041,3631
00935533,36047053100,"Census Tract 531, Kings County, New York",8415,8211,27,51,83,615,7800
00935511,36047053500,"Census Tract 535, Kings County, New York",4061,3819,0,0,242,297,3764
BB041154,36047053500,"Census Tract 535, Kings County, New York",4061,3819,0,0,242,297,3764
00935544,36047053500,"Census Tract 535, Kings County, New York",4061,3819,0,0,242,297,3764
00935566,36047053500,"Census Tract 535, Kings County, New York",4061,3819,0,0,242,297,3764
BB041161,36047053500,"Census Tract 535, Kings County, New York",4061,3819,0,0,242,297,3764
BB081245,36047053500,"Census Tract 535, Kings County, New York",4061,3819,0,0,242,297,3764
A9702490,36047052900,"Census Tract 529, Kings County, New York",4246,3872,61,0,313,395,3851
01903963,36047052900,"Census Tract 529, Kings County, New York",4246,3872,61,0,313,395,3851
A0302192,36047052900,"Census Tract 529, Kings County, New York",4246,3872,61,0,313,395,3851
BB940396,36047051900,"Census Tract 519, Kings County, New York",4297,3350,129,271,361,592,3705
A1171233,36047051900,"Census Tract 519, Kings County, New York",4297,3350,129,271,361,592,3705
BB963544,36047052700,"Census Tract 527, Kings County, New York",6520,3704,823,247,1374,4804,1716
BB041128,36047053300,"Census Tract 533, Kings County, New York",6704,6569,93,17,12,169,6535
A0502488,36047053300,"Census Tract 533, Kings County, New York",6704,6569,93,17,12,169,6535
BB121462,36047053300,"Census Tract 533, Kings County, New York",6704,6569,93,17,12,169,6535
BB963925,36047020500,"Census Tract 205, Kings County, New York",2609,1548,714,162,3,135,2474
A9502963,36047040600,"Census Tract 406, Kings County, New York",3030,1359,26,1421,92,392,2638
BB081303,36047021600,"Census Tract 216, Kings County, New York",4210,3470,0,740,0,246,3964
A0701591,36047015700,"Census Tract 157, Kings County, New York",4397,3667,155,357,40,248,4149
00924281,36047015700,"Census Tract 157, Kings County, New York",4397,3667,155,357,40,248,4149
00937315,36047009400,"Census Tract 94, Kings County, New York",5972,1466,78,3596,737,1259,4713
00938159,36047045600,"Census Tract 456, Kings County, New York",2532,2242,24,119,39,56,2476
00924725,36047010800,"Census Tract 108, Kings County, New York",4661,658,35,3460,237,654,4007
00924703,36047006200,"Census Tract 62, Kings County, New York",2883,1909,167,470,291,569,2314
BB981088,36047023200,"Census Tract 232, Kings County, New York",6142,5279,40,400,410,618,5524
A0302319,36047023200,"Census Tract 232, Kings County, New York",6142,5279,40,400,410,618,5524
A0302338,36047023200,"Census Tract 232, Kings County, New York",6142,5279,40,400,410,618,5524
00936129,36047023200,"Census Tract 232, Kings County, New York",6142,5279,40,400,410,618,5524
A0701589,36047023200,"Census Tract 232, Kings County, New York",6142,5279,40,400,410,618,5524
A0701707,36047023200,"Census Tract 232, Kings County, New York",6142,5279,40,400,410,618,5524
AA001438,36047023200,"Census Tract 232, Kings County, New York",6142,5279,40,400,410,618,5524
BB021353,36047023200,"Census Tract 232, Kings County, New York",6142,5279,40,400,410,618,5524
A1101637,36047023200,"Census Tract 232, Kings County, New York",6142,5279,40,400,410,618,5524
00921611,36005026702,"Census Tract 267.02, Bronx County, New York",6206,941,1094,165,3674,5002,1204
00922659,36005009000,"Census Tract 90, Bronx County, New York",3824,1328,1361,152,910,2493,1331
A0502570,36047053900,"Census Tract 539, Kings County, New York",2756,2621,77,9,22,436,2320
AA890622,36047054700,"Census Tract 547, Kings County, New York",5031,4157,189,271,329,984,4047
BB981066,36047053700,"Census Tract 537, Kings County, New York",3540,3394,57,0,12,156,3384
BB121670,36047053700,"Census Tract 537, Kings County, New York",3540,3394,57,0,12,156,3384
A1101654,36047053700,"Census Tract 537, Kings County, New York",3540,3394,57,0,12,156,3384
A0502598,36047054300,"Census Tract 543, Kings County, New York",347,176,78,9,62,92,255
A1101715,36047055000,"Census Tract 550, Kings County, New York",3607,2974,56,269,287,451,3156
A0902439,36047055400,"Census Tract 554, Kings County, New York",3684,2882,68,375,359,461,3223
00942267,36047055600,"Census Tract 556, Kings County, New York",3885,3411,27,437,10,41,3844
BB061091,36047078400,"Census Tract 784, Kings County, New York",2660,35,2352,14,170,202,2458
00938319,36047031702,"Census Tract 317.02, Kings County, New York",4114,775,2803,106,312,727,3387
BB121545,36047031702,"Census Tract 317.02, Kings County, New York",4114,775,2803,106,312,727,3387
A0502451,36047033700,"Census Tract 337, Kings County, New York",3832,1730,2007,0,70,325,3507
BB963601,36047033700,"Census Tract 337, Kings County, New York",3832,1730,2007,0,70,325,3507
A0502571,36047033700,"Census Tract 337, Kings County, New York",3832,1730,2007,0,70,325,3507
BB981100,36047057100,"Census Tract 571, Kings County, New York",3873,3741,15,83,0,148,3725
A0107913,36047004300,"Census Tract 43, Kings County, New York",3107,2104,170,271,426,575,2532
A9300665,36047004300,"Census Tract 43, Kings County, New York",3107,2104,170,271,426,575,2532
00938206,36047055200,"Census Tract 552, Kings County, New York",3253,2223,30,980,1,85,3168
AA890630,36047055200,"Census Tract 552, Kings County, New York",3253,2223,30,980,1,85,3168
BB041233,36047055200,"Census Tract 552, Kings County, New York",3253,2223,30,980,1,85,3168
A9903150,36047055200,"Census Tract 552, Kings County, New York",3253,2223,30,980,1,85,3168
BB121487,36047039400,"Census Tract 394, Kings County, New York",2152,1897,0,43,46,104,2048
A0502423,36047047200,"Census Tract 472, Kings County, New York",2894,2871,9,0,0,16,2878
A9903297,36047047200,"Census Tract 472, Kings County, New York",2894,2871,9,0,0,16,2878
BB121497,36047047200,"Census Tract 472, Kings County, New York",2894,2871,9,0,0,16,2878
BB121671,36047047200,"Census Tract 472, Kings County, New York",2894,2871,9,0,0,16,2878
A9903260,36047047200,"Census Tract 472, Kings County, New York",2894,2871,9,0,0,16,2878
01607578,36047057800,"Census Tract 578, Kings County, New York",3141,1824,46,973,134,310,2831
BB021405,36047057800,"Census Tract 578, Kings County, New York",3141,1824,46,973,134,310,2831
00926369,36047056600,"Census Tract 566, Kings County, New York",2951,1767,105,950,62,230,2721
A0902352,36047058000,"Census Tract 580, Kings County, New York",3833,2069,15,1516,183,817,3016
A9104979,36047085400,"Census Tract 854, Kings County, New York",1804,0,1688,8,31,109,1695
BB101104,36047090200,"Census Tract 902, Kings County, New York",3958,79,3090,190,524,814,3144
BB963585,36047090200,"Census Tract 902, Kings County, New York",3958,79,3090,190,524,814,3144
00943613,36047093600,"Census Tract 936, Kings County, New York",1931,0,1844,67,0,21,1910
K9500356,36047092200,"Census Tract 922, Kings County, New York",2927,177,2712,0,0,203,2724
A0502525,36047084600,"Census Tract 846, Kings County, New York",1555,22,1470,0,37,37,1518
BB041114,36047084600,"Census Tract 846, Kings County, New York",1555,22,1470,0,37,37,1518
00943566,36047084600,"Census Tract 846, Kings County, New York",1555,22,1470,0,37,37,1518
00924452,36047069000,"Census Tract 690, Kings County, New York",1827,484,1175,22,27,235,1592
00924339,36047102800,"Census Tract 1028, Kings County, New York",1523,29,1380,97,17,39,1484
BB963333,36047000100,"Census Tract 1, Kings County, New York",4367,3149,410,260,364,585,3782
A9104780,36047000301,"Census Tract 3.01, Kings County, New York",3944,3221,217,101,89,487,3457
A0701595,36047014100,"Census Tract 141, Kings County, New York",3980,2429,298,552,514,921,3059
A0508014,36047014100,"Census Tract 141, Kings County, New York",3980,2429,298,552,514,921,3059
BB963250,36047014500,"Census Tract 145, Kings County, New York",4629,2879,214,370,941,1668,2961
00924667,36047015000,"Census Tract 150, Kings County, New York",1660,1407,2,233,18,75,1585
A0902326,36047016100,"Census Tract 161, Kings County, New York",3167,2240,428,268,90,372,2795
BB963626,36047016500,"Census Tract 165, Kings County, New York",5638,4459,176,401,190,473,5165
00926063,36047016700,"Census Tract 167, Kings County, New York",4946,4070,108,249,375,630,4316
00926074,36047016700,"Census Tract 167, Kings County, New York",4946,4070,108,249,375,630,4316
00924394,36047016900,"Census Tract 169, Kings County, New York",4620,3232,228,780,290,783,3837
00926132,36047016200,"Census Tract 162, Kings County, New York",2574,1614,110,548,242,350,2224
A9303708,36047087000,"Census Tract 870, Kings County, New York",3124,38,2915,0,171,282,2842
01904107,36047086000,"Census Tract 860, Kings County, New York",3398,27,3249,75,45,268,3130
A0107447,36047087401,"Census Tract 874.01, Kings County, New York",3395,156,2975,50,177,344,3051
BB041118,36047085600,"Census Tract 856, Kings County, New York",3521,16,3375,20,36,354,3167
BB963874,36047088200,"Census Tract 882, Kings County, New York",6587,99,6280,109,48,231,6356
A0107454,36047065000,"Census Tract 650, Kings County, New York",1465,615,506,199,145,93,1372
A0701652,36047064400,"Census Tract 644, Kings County, New York",2872,2198,27,548,95,305,2567
00926201,36047060000,"Census Tract 600, Kings County, New York",5510,4979,98,430,3,467,5043
A9104921,36005023704,"Census Tract 237.04, Bronx County, New York",3702,422,1144,20,2021,2704,998
A0502398,36047002000,"Census Tract 20, Kings County, New York",1321,425,121,87,670,1066,255
BB061076,36047000900,"Census Tract 9, Kings County, New York",4163,3074,268,478,157,338,3825
00935205,36047001100,"Census Tract 11, Kings County, New York",701,451,74,89,38,69,632
BB101004,36047001100,"Census Tract 11, Kings County, New York",701,451,74,89,38,69,632
A0507969,36047003700,"Census Tract 37, Kings County, New York",882,675,29,79,56,121,761
00925933,36047003400,"Census Tract 34, Kings County, New York",3127,2679,29,352,19,288,2839
00923164,36005016400,"Census Tract 164, Bronx County, New York",907,691,72,0,117,326,581
00923051,36005023301,"Census Tract 233.01, Bronx County, New York",4378,403,1365,0,2412,3153,1225
00922251,36005019500,"Census Tract 195, Bronx County, New York",7593,1056,2606,100,3748,5235,2358
00922513,36005036800,"Census Tract 368, Bronx County, New York",2364,143,1834,0,356,569,1795
00938512,36005028600,"Census Tract 286, Bronx County, New York",1225,912,12,144,157,297,928
00921542,36005021100,"Census Tract 211, Bronx County, New York",5721,745,2631,12,2178,3319,2402
00926391,36047019700,"Census Tract 197, Kings County, New York",3348,1566,1270,243,74,223,3125
00926438,36047019700,"Census Tract 197, Kings County, New York",3348,1566,1270,243,74,223,3125
A9105030,36047020600,"Census Tract 206, Kings County, New York",2611,1693,19,878,21,192,2419
A9104844,36047019200,"Census Tract 192, Kings County, New York",3264,2024,5,1025,210,437,2827
00921633,36005046000,"Census Tract 460, Bronx County, New York",2608,115,2074,11,340,572,2036
00921484,36005043100,"Census Tract 431, Bronx County, New York",10419,1654,2677,1193,4343,5683,4736
00921371,36005029700,"Census Tract 297, Bronx County, New York",3971,3186,257,71,234,785,3186
BB081280,36047021800,"Census Tract 218, Kings County, New York",4630,4146,23,348,92,316,4314
A9105112,36047021800,"Census Tract 218, Kings County, New York",4630,4146,23,348,92,316,4314
A0902392,36047021800,"Census Tract 218, Kings County, New York",4630,4146,23,348,92,316,4314
A1101653,36047021800,"Census Tract 218, Kings County, New York",4630,4146,23,348,92,316,4314
BB101051,36047021900,"Census Tract 219, Kings County, New York",3855,754,2514,228,288,402,3453
00937687,36047020800,"Census Tract 208, Kings County, New York",3153,1658,34,1362,17,164,2989
BB121569,36047021400,"Census Tract 214, Kings County, New York",2599,1258,0,1322,7,185,2414
BB081358,36081127700,"Census Tract 1277, Queens County, New York",3409,2441,221,630,105,140,3269
A9104737,36081062200,"Census Tract 622, Queens County, New York",1668,18,1599,20,13,59,1609
A9702510,36081062200,"Census Tract 622, Queens County, New York",1668,18,1599,20,13,59,1609
BB121760,36081025400,"Census Tract 254, Queens County, New York",12663,98,6528,651,1363,5179,7484
A1101734,36081006502,"Census Tract 65.02, Queens County, New York",3976,2865,73,719,62,593,3383
00925445,36081065703,"Census Tract 657.03, Queens County, New York",2858,2772,1,15,70,467,2391
K9304074,36081074900,"Census Tract 749, Queens County, New York",1628,1216,0,335,44,97,1531
00925423,36081061301,"Census Tract 613.01, Queens County, New York",5782,4894,93,403,262,1475,4307
A0701731,36047101800,"Census Tract 1018, Kings County, New York",1642,64,1488,0,60,78,1564
A9104831,36047112600,"Census Tract 1126, Kings County, New York",3936,526,2983,19,408,1056,2880
BB963353,36047112200,"Census Tract 1122, Kings County, New York",3456,458,2741,50,207,582,2874
A0107936,36047112400,"Census Tract 1124, Kings County, New York",3361,85,3127,0,147,298,3063
A0502402,36047112400,"Census Tract 1124, Kings County, New York",3361,85,3127,0,147,298,3063
K9304029,36047117400,"Census Tract 1174, Kings County, New York",3956,2416,896,370,204,2813,1143
BB121471,36047120800,"Census Tract 1208, Kings County, New York",8706,882,7194,115,286,1394,7312
A9104797,36081003300,"Census Tract 33, Queens County, New York",2675,1333,103,1010,164,856,1819
00938931,36081053100,"Census Tract 531, Queens County, New York",2486,2209,27,54,184,761,1725
BB121591,36047022200,"Census Tract 222, Kings County, New York",4471,4085,43,0,337,569,3902
00942879,36047013000,"Census Tract 130, Kings County, New York",4971,3066,116,1059,582,1113,3858
A9903295,36047023800,"Census Tract 238, Kings County, New York",4167,4153,0,0,0,227,3940
A9105087,36047023800,"Census Tract 238, Kings County, New York",4167,4153,0,0,0,227,3940
01904184,36047023800,"Census Tract 238, Kings County, New York",4167,4153,0,0,0,227,3940
00943395,36047023800,"Census Tract 238, Kings County, New York",4167,4153,0,0,0,227,3940
A9300684,36047048600,"Census Tract 486, Kings County, New York",3492,1200,51,1480,726,1088,2404
A0902331,36047054200,"Census Tract 542, Kings County, New York",4608,3779,101,324,344,497,4111
A0902373,36047053800,"Census Tract 538, Kings County, New York",3922,3006,47,271,545,656,3266
A0302232,36081099801,"Census Tract 998.01, Queens County, New York",7110,1576,4811,348,240,1531,5579
A9903146,36081075702,"Census Tract 757.02, Queens County, New York",4408,2666,295,1255,61,481,3927
00925558,36081071701,"Census Tract 717.01, Queens County, New York",5236,3801,114,1139,128,575,4661
BB041308,36081075701,"Census Tract 757.01, Queens County, New York",5102,3393,31,1445,176,617,4485
BB061156,36081093401,"Census Tract 934.01, Queens County, New York",3641,3360,73,81,119,410,3231
00920833,36061021303,"Census Tract 213.03, New York County, New York",5686,929,2752,55,1622,1987,3699
A9903238,36005040501,"Census Tract 405.01, Bronx County, New York",3916,379,1009,212,2194,2646,1270
A9702471,36005018302,"Census Tract 183.02, Bronx County, New York",3934,566,1075,92,1910,2719,1215
00919373,36005032600,"Census Tract 326, Bronx County, New York",3573,2063,445,300,646,971,2602
00935919,36005029302,"Census Tract 293.02, Bronx County, New York",5471,4079,407,195,658,1167,4304
00919602,36005027402,"Census Tract 274.02, Bronx County, New York",3754,3192,155,104,277,788,2966
00919158,36005021001,"Census Tract 210.01, Bronx County, New York",9094,622,5398,395,2264,3202,5892
00922692,36005021001,"Census Tract 210.01, Bronx County, New York",9094,622,5398,395,2264,3202,5892
00919533,36005021002,"Census Tract 210.02, Bronx County, New York",6081,508,3873,622,740,1373,4708
00920888,36005039500,"Census Tract 395, Bronx County, New York",3893,440,1702,0,1681,2629,1264
00922681,36005033700,"Census Tract 337, Bronx County, New York",2353,1810,187,117,146,293,2060
A9300660,36005033500,"Census Tract 335, Bronx County, New York",2323,1685,169,255,175,381,1942
AA890650,36005033500,"Census Tract 335, Bronx County, New York",2323,1685,169,255,175,381,1942
A0108089,36005033500,"Census Tract 335, Bronx County, New York",2323,1685,169,255,175,381,1942
00919249,36005022200,"Census Tract 222, Bronx County, New York",2965,664,631,360,1195,1883,1082
A0508010,36005022200,"Census Tract 222, Bronx County, New York",2965,664,631,360,1195,1883,1082
X0921451,36005044400,"Census Tract 444, Bronx County, New York",3617,297,2822,53,315,593,3024
00919872,36005044400,"Census Tract 444, Bronx County, New York",3617,297,2822,53,315,593,3024
A9702478,36005009300,"Census Tract 93, Bronx County, New York",6265,1491,1791,0,2737,4488,1777
00937701,36085014604,"Census Tract 146.04, Richmond County, New York",7666,7227,0,355,44,775,6891
AA001198,36085025100,"Census Tract 251, Richmond County, New York",5796,5460,0,285,51,290,5506
00922579,36085029103,"Census Tract 291.03, Richmond County, New York",7405,6605,107,693,0,647,6758
A1101630,36085029103,"Census Tract 291.03, Richmond County, New York",7405,6605,107,693,0,647,6758
A9105127,36085027900,"Census Tract 279, Richmond County, New York",2106,1967,27,87,0,138,1968
00919293,36085014100,"Census Tract 141, Richmond County, New York",2725,1855,393,153,287,1247,1478
00935373,36085024402,"Census Tract 244.02, Richmond County, New York",4426,3980,0,446,0,447,3979
A1101633,36061001501,"Census Tract 15.01, New York County, New York",6006,3759,381,1575,166,534,5472
02161995,36061003601,"Census Tract 36.01, New York County, New York",3266,1493,387,719,456,1156,2110
01607476,36061003800,"Census Tract 38, New York County, New York",8407,6071,443,1368,106,841,7566
00919828,36061003800,"Census Tract 38, New York County, New York",8407,6071,443,1368,106,841,7566
A1101727,36061003300,"Census Tract 33, New York County, New York",5262,4237,127,554,64,382,4880
00919599,36061002900,"Census Tract 29, New York County, New York",5841,582,706,4118,160,597,5244
00938374,36061007000,"Census Tract 70, New York County, New York",7977,5782,120,1689,144,242,7735
00939152,36061006100,"Census Tract 61, New York County, New York",4997,4141,111,544,131,383,4614
A9303745,36061005400,"Census Tract 54, New York County, New York",4533,3722,112,399,118,469,4064
00919613,36061005400,"Census Tract 54, New York County, New York",4533,3722,112,399,118,469,4064
A0502407,36061005400,"Census Tract 54, New York County, New York",4533,3722,112,399,118,469,4064
00922422,36061006400,"Census Tract 64, New York County, New York",7634,6021,284,879,57,431,7203
A1101658,36061006800,"Census Tract 68, New York County, New York",6973,5383,527,772,230,576,6397
00922466,36061006700,"Census Tract 67, New York County, New York",5006,4325,176,331,0,208,4798
00935227,36061006900,"Census Tract 69, New York County, New York",2684,2203,100,187,82,175,2509
A0107526,36061004900,"Census Tract 49, New York County, New York",4544,3989,110,336,59,265,4279
00936537,36061007100,"Census Tract 71, New York County, New York",5987,4863,83,765,77,219,5768
00921917,36061007100,"Census Tract 71, New York County, New York",5987,4863,83,765,77,219,5768
A0902269,36061006200,"Census Tract 62, New York County, New York",4559,2604,723,890,249,643,3916
AA001646,36061008100,"Census Tract 81, New York County, New York",8799,7200,217,675,376,924,7875
K9303939,36061008100,"Census Tract 81, New York County, New York",8799,7200,217,675,376,924,7875
A0302253,36061008800,"Census Tract 88, New York County, New York",6747,4742,142,1482,60,373,6374
00942201,36061007500,"Census Tract 75, New York County, New York",4554,4234,28,252,9,374,4180
00942052,36061009800,"Census Tract 98, New York County, New York",7233,5978,142,974,39,453,6780
A0502391,36061009000,"Census Tract 90, New York County, New York",7194,5009,176,1884,0,599,6595
00920119,36061009900,"Census Tract 99, New York County, New York",4042,2535,215,1075,91,294,3748
00939651,36061011401,"Census Tract 114.01, New York County, New York",1337,1176,13,135,0,8,1329
00920108,36061012100,"Census Tract 121, New York County, New York",8288,6514,502,850,183,1501,6787
00941092,36061012000,"Census Tract 120, New York County, New York",3282,3031,43,176,0,173,3109
A9502997,36061012000,"Census Tract 120, New York County, New York",3282,3031,43,176,0,173,3109
00919588,36061012000,"Census Tract 120, New York County, New York",3282,3031,43,176,0,173,3109
00919169,36061013300,"Census Tract 133, New York County, New York",5226,3638,226,704,367,1207,4019
BB121798,36061013300,"Census Tract 133, New York County, New York",5226,3638,226,704,367,1207,4019
00936956,36061013400,"Census Tract 134, New York County, New York",11195,9825,99,685,130,783,10412
X0939378,36061013400,"Census Tract 134, New York County, New York",11195,9825,99,685,130,783,10412
01607487,36061012800,"Census Tract 128, New York County, New York",5875,5608,7,148,18,287,5588
00939072,36061012800,"Census Tract 128, New York County, New York",5875,5608,7,148,18,287,5588
00939389,36061013000,"Census Tract 130, New York County, New York",3693,3429,10,146,0,132,3561
A9903185,36061013700,"Census Tract 137, New York County, New York",6977,5469,97,1273,54,374,6603
A9105048,36061013700,"Census Tract 137, New York County, New York",6977,5469,97,1273,54,374,6603
00940612,36061013200,"Census Tract 132, New York County, New York",9869,8860,21,668,81,768,9101
00939695,36061013200,"Census Tract 132, New York County, New York",9869,8860,21,668,81,768,9101
A0107837,36061014801,"Census Tract 148.01, New York County, New York",2933,2388,52,308,80,146,2787
00939094,36061014401,"Census Tract 144.01, New York County, New York",4956,4504,16,341,65,287,4669
A9303747,36061016001,"Census Tract 160.01, New York County, New York",3695,3343,6,235,10,246,3449
00939174,36061016001,"Census Tract 160.01, New York County, New York",3695,3343,6,235,10,246,3449
K9303955,36061016001,"Census Tract 160.01, New York County, New York",3695,3343,6,235,10,246,3449
00941729,36061014802,"Census Tract 148.02, New York County, New York",7125,5997,89,658,23,364,6761
A9104974,36061015700,"Census Tract 157, New York County, New York",10123,9160,95,649,11,407,9716
00921779,36061015700,"Census Tract 157, New York County, New York",10123,9160,95,649,11,407,9716
A0740101,36061015700,"Census Tract 157, New York County, New York",10123,9160,95,649,11,407,9716
00941183,36061015801,"Census Tract 158.01, New York County, New York",5585,4992,232,228,44,366,5219
A0701711,36061016100,"Census Tract 161, New York County, New York",6563,5723,93,491,119,220,6343
A9104674,36061014000,"Census Tract 140, New York County, New York",7633,6777,70,663,32,408,7225
00938283,36061014000,"Census Tract 140, New York County, New York",7633,6777,70,663,32,408,7225
BB121823,36061015500,"Census Tract 155, New York County, New York",10244,8492,169,1040,163,488,9756
A0502592,36061015900,"Census Tract 159, New York County, New York",8621,7569,153,661,93,485,8136
00938261,36061014500,"Census Tract 145, New York County, New York",5460,4370,169,721,57,539,4921
A0740098,36061015100,"Census Tract 151, New York County, New York",7480,4245,815,1338,626,2352,5128
A9105054,36061018100,"Census Tract 181, New York County, New York",9267,5966,2026,848,237,1588,7679
A0902400,36061018100,"Census Tract 181, New York County, New York",9267,5966,2026,848,237,1588,7679
00938272,36061018100,"Census Tract 181, New York County, New York",9267,5966,2026,848,237,1588,7679
00939979,36061017700,"Census Tract 177, New York County, New York",9426,5486,1691,752,831,2772,6654
A0302301,36061017700,"Census Tract 177, New York County, New York",9426,5486,1691,752,831,2772,6654
00942722,36061017700,"Census Tract 177, New York County, New York",9426,5486,1691,752,831,2772,6654
00919817,36061017300,"Census Tract 173, New York County, New York",8968,6784,604,843,351,1541,7427
A0107885,36061017300,"Census Tract 173, New York County, New York",8968,6784,604,843,351,1541,7427
A0302186,36061017300,"Census Tract 173, New York County, New York",8968,6784,604,843,351,1541,7427
00942697,36061017300,"Census Tract 173, New York County, New York",8968,6784,604,843,351,1541,7427
A1101731,36061017300,"Census Tract 173, New York County, New York",8968,6784,604,843,351,1541,7427
00919952,36061017500,"Census Tract 175, New York County, New York",10933,9354,378,328,145,1720,9213
AA890707,36061017500,"Census Tract 175, New York County, New York",10933,9354,378,328,145,1720,9213
00919511,36061018200,"Census Tract 182, New York County, New York",6553,1376,1784,126,3133,4111,2442
A9903226,36061017100,"Census Tract 171, New York County, New York",9441,7657,823,487,51,968,8473
A1140018,36061018500,"Census Tract 185, New York County, New York",5296,3538,749,670,42,341,4955
00920822,36061019500,"Census Tract 195, New York County, New York",7911,5670,653,1076,253,1674,6237
A0502577,36061019500,"Census Tract 195, New York County, New York",7911,5670,653,1076,253,1674,6237
00944107,36061018600,"Census Tract 186, New York County, New York",7245,1051,4271,266,1518,2478,4767
A0701621,36061018600,"Census Tract 186, New York County, New York",7245,1051,4271,266,1518,2478,4767
00922433,36061018300,"Census Tract 183, New York County, New York",8382,6254,642,905,439,1433,6949
00937927,36061019701,"Census Tract 197.01, New York County, New York",898,551,73,216,0,197,701
00922455,36061019200,"Census Tract 192, New York County, New York",4103,509,1750,190,1361,2283,1820
A0902279,36061021800,"Census Tract 218, New York County, New York",7381,1549,4583,189,835,1124,6257
A9104755,36061020600,"Census Tract 206, New York County, New York",3025,400,2232,109,151,439,2586
00920006,36061022700,"Census Tract 227, New York County, New York",5532,1258,2884,146,500,1905,3627
00919486,36061021200,"Census Tract 212, New York County, New York",4211,407,3118,215,290,810,3401
A9702472,36061020000,"Census Tract 200, New York County, New York",3018,834,1612,194,231,425,2593
A0302227,36061020000,"Census Tract 200, New York County, New York",3018,834,1612,194,231,425,2593
00922783,36061020300,"Census Tract 203, New York County, New York",3368,2108,403,646,11,239,3129
00922954,36061023000,"Census Tract 230, New York County, New York",9124,1239,6375,73,563,2290,6834
00919941,36061022600,"Census Tract 226, New York County, New York",4053,574,2843,66,428,680,3373
00926212,36047150200,"Census Tract 1502, Kings County, New York",2900,2184,63,217,255,497,2403
A0508005,36047150200,"Census Tract 1502, Kings County, New York",2900,2184,63,217,255,497,2403
00922648,36005007000,"Census Tract 70, Bronx County, New York",4646,938,1166,429,1959,2896,1750
00921473,36005007800,"Census Tract 78, Bronx County, New York",6868,1258,1616,648,3006,4363,2505
00922273,36005006100,"Census Tract 61, Bronx County, New York",4007,175,3392,0,258,536,3471
00937803,36047015200,"Census Tract 152, Kings County, New York",2595,1886,42,587,42,217,2378
A9104711,36047114400,"Census Tract 1144, Kings County, New York",2700,475,1743,0,430,938,1762
A0971529,36005022500,"Census Tract 225, Bronx County, New York",8071,1050,2783,0,4019,5511,2560
00922218,36005021800,"Census Tract 218, Bronx County, New York",7049,876,2132,660,3227,4347,2702
00919125,36005012101,"Census Tract 121.01, Bronx County, New York",3014,416,842,81,1541,2204,810
00920094,36005001600,"Census Tract 16, Bronx County, New York",5412,1855,1806,0,1660,3694,1718
00944173,36005013500,"Census Tract 135, Bronx County, New York",3957,359,1463,0,1770,2618,1339
00921553,36005013200,"Census Tract 132, Bronx County, New York",7150,3453,815,450,2307,3607,3543
00922207,36005008900,"Census Tract 89, Bronx County, New York",3540,641,855,12,1717,2848,692
A9702395,36047093200,"Census Tract 932, Kings County, New York",1280,19,1228,0,7,15,1265
A1101674,36005009200,"Census Tract 92, Bronx County, New York",5397,900,730,806,2761,3430,1967
A0902364,36047011900,"Census Tract 119, Kings County, New York",1915,1217,60,88,406,733,1182
A0302183,36047011900,"Census Tract 119, Kings County, New York",1915,1217,60,88,406,733,1182
00921349,36005002300,"Census Tract 23, Bronx County, New York",4860,779,2369,0,1556,2985,1875
00922502,36005002702,"Census Tract 27.02, Bronx County, New York",4683,1012,1550,0,1939,3355,1328
00920243,36085024401,"Census Tract 244.01, Richmond County, New York",6199,5953,0,128,17,348,5851
00924496,36047094600,"Census Tract 946, Kings County, New York",1985,176,1689,0,4,156,1829
A9104975,36047094600,"Census Tract 946, Kings County, New York",1985,176,1689,0,4,156,1829
A9903221,36047076800,"Census Tract 768, Kings County, New York",3512,2789,46,393,190,295,3217
BB963838,36047076800,"Census Tract 768, Kings County, New York",3512,2789,46,393,190,295,3217
02046032,36047076800,"Census Tract 768, Kings County, New York",3512,2789,46,393,190,295,3217
00938079,36047076800,"Census Tract 768, Kings County, New York",3512,2789,46,393,190,295,3217
A0502599,36047076800,"Census Tract 768, Kings County, New York",3512,2789,46,393,190,295,3217
A9104913,36047076800,"Census Tract 768, Kings County, New York",3512,2789,46,393,190,295,3217
BB121623,36047076800,"Census Tract 768, Kings County, New York",3512,2789,46,393,190,295,3217
00921382,36005011800,"Census Tract 118, Bronx County, New York",5328,4497,108,236,326,822,4506
00919522,36005041100,"Census Tract 411, Bronx County, New York",2928,513,692,134,1447,1887,1041
00921407,36005042300,"Census Tract 423, Bronx County, New York",4203,1128,788,474,1561,2494,1709
A0701725,36005042600,"Census Tract 426, Bronx County, New York",7198,221,6284,234,424,705,6493
A0302251,36005042600,"Census Tract 426, Bronx County, New York",7198,221,6284,234,424,705,6493
01657789,36005035100,"Census Tract 351, Bronx County, New York",3202,2068,256,216,607,980,2222
00937075,36005035100,"Census Tract 351, Bronx County, New York",3202,2068,256,216,607,980,2222
00922171,36005045102,"Census Tract 451.02, Bronx County, New York",1847,1554,55,66,151,223,1624
A1101662,36005046201,"Census Tract 462.01, Bronx County, New York",28827,5610,16941,223,4916,9729,19098
00921826,36005037200,"Census Tract 372, Bronx County, New York",2280,212,1377,76,399,679,1601
A0971586,36005037200,"Census Tract 372, Bronx County, New York",2280,212,1377,76,399,679,1601
A1101649,36005037400,"Census Tract 374, Bronx County, New York",3525,297,2000,111,852,1479,2046
00921622,36005048400,"Census Tract 484, Bronx County, New York",3779,356,2960,11,373,621,3158
00919238,36005032800,"Census Tract 328, Bronx County, New York",4354,1148,1191,595,1265,2042,2312
00920968,36005051600,"Census Tract 516, Bronx County, New York",4336,3544,58,18,675,938,3398
A0302248,36005039800,"Census Tract 398, Bronx County, New York",2899,160,2597,28,114,149,2750
BB963579,36047088600,"Census Tract 886, Kings County, New York",4321,18,4040,0,139,406,3915
A9903214,36047088600,"Census Tract 886, Kings County, New York",4321,18,4040,0,139,406,3915
A0971582,36047089000,"Census Tract 890, Kings County, New York",6781,272,6163,30,284,614,6167
BB081251,36047089000,"Census Tract 890, Kings County, New York",6781,272,6163,30,284,614,6167
00924543,36047006600,"Census Tract 66, Kings County, New York",3933,2898,55,471,459,880,3053
BB121474,36047006600,"Census Tract 66, Kings County, New York",3933,2898,55,471,459,880,3053
AA000919,36047006900,"Census Tract 69, Kings County, New York",3913,2781,119,212,236,863,3050
BB940402,36047006800,"Census Tract 68, Kings County, New York",5213,3392,92,835,663,1563,3650
00925944,36047005201,"Census Tract 52.01, Kings County, New York",1716,1381,19,235,7,110,1606
A9104857,36047005000,"Census Tract 50, Kings County, New York",2468,2249,14,150,1,251,2217
00926416,36047005602,"Census Tract 56.02, Kings County, New York",1862,1384,0,234,216,355,1507
A0107874,36047011200,"Census Tract 112, Kings County, New York",6503,3402,244,1375,1428,2465,4038
A0509133,36047011200,"Census Tract 112, Kings County, New York",6503,3402,244,1375,1428,2465,4038
A0302240,36047011200,"Census Tract 112, Kings County, New York",6503,3402,244,1375,1428,2465,4038
A0107783,36047012901,"Census Tract 129.01, Kings County, New York",2724,1331,119,196,978,1042,1682
A0107432,36047013400,"Census Tract 134, Kings County, New York",4029,2970,10,591,324,680,3349
00940587,36081108500,"Census Tract 1085, Queens County, New York",2764,1346,42,1209,79,314,2450
BB081386,36081109300,"Census Tract 1093, Queens County, New York",3312,1965,51,864,301,667,2645
00941296,36061016900,"Census Tract 169, New York County, New York",7811,6583,429,417,111,589,7222
A9702381,36061016400,"Census Tract 164, New York County, New York",6722,2051,1947,720,1733,3127,3595
